Sub,SupraThresholdFD,TotalVolume,ScrubRatio,VolumesPostCensor,Time(seconds),Time (minutes),FD threshold (mm),Subject
sub-2006_ses-T1,392,420,0.933333333,28,56,0.933333333,0.5,1
sub-2011_ses-T1,353,360,0.980555556,7,14,0.233333333,0.5,2
sub-2012_ses-T1,179,180,0.994444444,1,2,0.033333333,0.5,3
sub-2013_ses-T1,350,360,0.972222222,10,20,0.333333333,0.5,4
sub-2014_ses-T1,355,360,0.986111111,5,10,0.166666667,0.5,5
sub-2015_ses-T1,149,180,0.827777778,31,62,1.033333333,0.5,6
sub-2016_ses-T1,357,360,0.991666667,3,6,0.1,0.5,7
sub-2017_ses-T1,179,180,0.994444444,1,2,0.033333333,0.5,8
sub-2018_ses-T1,177,180,0.983333333,3,6,0.1,0.5,9
sub-2019_ses-T1,357,360,0.991666667,3,6,0.1,0.5,10
sub-2020_ses-T1,19,26,0.730769231,7,14,0.233333333,0.5,11
sub-2020_ses-T2,352,360,0.977777778,8,16,0.266666667,0.5,12
sub-2021_ses-T1,357,360,0.991666667,3,6,0.1,0.5,13
sub-2022_ses-T1,347,360,0.963888889,13,26,0.433333333,0.5,14
sub-2023_ses-T1,263,360,0.730555556,97,194,3.233333333,0.5,15
sub-2024_ses-T2,11,12,0.916666667,1,2,0.033333333,0.5,16
sub-2026_ses-T1,221,223,0.99103139,2,4,0.066666667,0.5,17
sub-2027_ses-T1,358,360,0.994444444,2,4,0.066666667,0.5,18
sub-2028_ses-T1,339,360,0.941666667,21,42,0.7,0.5,19
sub-2029_ses-T1,354,360,0.983333333,6,12,0.2,0.5,20
sub-2030_ses-T1,341,360,0.947222222,19,38,0.633333333,0.5,21
sub-2031_ses-T1,358,360,0.994444444,2,4,0.066666667,0.5,22
sub-2032_ses-T1,331,360,0.919444444,29,58,0.966666667,0.5,23
sub-2033_ses-T1,358,360,0.994444444,2,4,0.066666667,0.5,24
sub-2033_ses-T2,302,360,0.838888889,58,116,1.933333333,0.5,25
sub-2034_ses-T1,161,180,0.894444444,19,38,0.633333333,0.5,26
sub-2035_ses-T1,358,360,0.994444444,2,4,0.066666667,0.5,27
sub-2036_ses-T1,357,360,0.991666667,3,6,0.1,0.5,28
sub-2037_ses-T1,356,360,0.988888889,4,8,0.133333333,0.5,29
sub-2038_ses-T1,358,360,0.994444444,2,4,0.066666667,0.5,30
sub-2039_ses-T1,179,180,0.994444444,1,2,0.033333333,0.5,31
sub-2040_ses-T1,358,360,0.994444444,2,4,0.066666667,0.5,32
sub-2041_ses-T1,358,360,0.994444444,2,4,0.066666667,0.5,33
sub-2042_ses-T1,179,180,0.994444444,1,2,0.033333333,0.5,34
sub-2043_ses-T1,314,360,0.872222222,46,92,1.533333333,0.5,35
sub-2044_ses-T1,343,360,0.952777778,17,34,0.566666667,0.5,36
sub-2045_ses-T1,172,180,0.955555556,8,16,0.266666667,0.5,37
sub-2046_ses-T1,178,180,0.988888889,2,4,0.066666667,0.5,38
sub-2047_ses-T1,177,180,0.983333333,3,6,0.1,0.5,39
sub-2048_ses-T1,178,180,0.988888889,2,4,0.066666667,0.5,40
sub-2049_ses-T1,357,360,0.991666667,3,6,0.1,0.5,41
sub-2051_ses-T1,358,360,0.994444444,2,4,0.066666667,0.5,42
sub-2051_ses-T2,358,360,0.994444444,2,4,0.066666667,0.5,43
sub-2052_ses-T1,347,360,0.963888889,13,26,0.433333333,0.5,44
sub-2052_ses-T2,158,180,0.877777778,22,44,0.733333333,0.5,45
sub-2053_ses-T1,341,360,0.947222222,19,38,0.633333333,0.5,46
sub-2055_ses-T1,154,180,0.855555556,26,52,0.866666667,0.5,47
sub-2056_ses-T1,358,360,0.994444444,2,4,0.066666667,0.5,48
sub-2057_ses-T1,358,360,0.994444444,2,4,0.066666667,0.5,49
sub-2058_ses-T1,297,360,0.825,63,126,2.1,0.5,50
sub-2059_ses-T1,284,360,0.788888889,76,152,2.533333333,0.5,51
sub-2061_ses-T1,167,180,0.927777778,13,26,0.433333333,0.5,52
sub-2062_ses-T1,357,360,0.991666667,3,6,0.1,0.5,53
sub-2063_ses-T1,353,360,0.980555556,7,14,0.233333333,0.5,54
sub-2064_ses-T1,179,180,0.994444444,1,2,0.033333333,0.5,55
sub-2065_ses-T1,170,180,0.944444444,10,20,0.333333333,0.5,56
sub-2066_ses-T1,178,180,0.988888889,2,4,0.066666667,0.5,57
sub-2066_ses-T2,357,360,0.991666667,3,6,0.1,0.5,58
sub-2067_ses-T1,357,360,0.991666667,3,6,0.1,0.5,59
sub-2068_ses-T1,358,360,0.994444444,2,4,0.066666667,0.5,60
sub-2069_ses-T1,355,360,0.986111111,5,10,0.166666667,0.5,61
sub-2070_ses-T1,351,360,0.975,9,18,0.3,0.5,62
sub-2071_ses-T1,357,360,0.991666667,3,6,0.1,0.5,63
sub-2072_ses-T1,358,360,0.994444444,2,4,0.066666667,0.5,64
sub-2073_ses-T1,254,256,0.9921875,2,4,0.066666667,0.5,65
sub-2073_ses-T2,174,180,0.966666667,6,12,0.2,0.5,66
sub-2074_ses-T1,175,180,0.972222222,5,10,0.166666667,0.5,67
sub-2075_ses-T1,179,180,0.994444444,1,2,0.033333333,0.5,68
sub-2076_ses-T1,352,360,0.977777778,8,16,0.266666667,0.5,69
sub-2076_ses-T2,337,360,0.936111111,23,46,0.766666667,0.5,70
sub-2077_ses-T1,358,360,0.994444444,2,4,0.066666667,0.5,71
sub-2078_ses-T1,358,360,0.994444444,2,4,0.066666667,0.5,72
sub-2079_ses-T1,357,360,0.991666667,3,6,0.1,0.5,73
sub-2079_ses-T2,332,360,0.922222222,28,56,0.933333333,0.5,74
sub-2080_ses-T1,326,360,0.905555556,34,68,1.133333333,0.5,75
sub-2081_ses-T1,358,360,0.994444444,2,4,0.066666667,0.5,76
sub-2082_ses-T1,350,360,0.972222222,10,20,0.333333333,0.5,77
sub-2083_ses-T1,330,360,0.916666667,30,60,1,0.5,78
sub-2084_ses-T1,358,360,0.994444444,2,4,0.066666667,0.5,79
sub-2085_ses-T1,353,360,0.980555556,7,14,0.233333333,0.5,80
sub-2086_ses-T1,311,360,0.863888889,49,98,1.633333333,0.5,81
sub-2087_ses-T1,355,360,0.986111111,5,10,0.166666667,0.5,82
sub-2088_ses-T1,357,360,0.991666667,3,6,0.1,0.5,83
sub-2089_ses-T1,179,180,0.994444444,1,2,0.033333333,0.5,84
sub-2091_ses-T1,338,360,0.938888889,22,44,0.733333333,0.5,85
sub-2092_ses-T1,354,360,0.983333333,6,12,0.2,0.5,86
sub-2093_ses-T1,357,360,0.991666667,3,6,0.1,0.5,87
sub-2094_ses-T1,173,180,0.961111111,7,14,0.233333333,0.5,88
sub-2095_ses-T1,358,360,0.994444444,2,4,0.066666667,0.5,89
sub-2096_ses-T1,353,360,0.980555556,7,14,0.233333333,0.5,90
sub-2097_ses-T1,535,540,0.990740741,5,10,0.166666667,0.5,91
sub-2098_ses-T1,329,360,0.913888889,31,62,1.033333333,0.5,92
sub-2099_ses-T1,178,180,0.988888889,2,4,0.066666667,0.5,93
sub-2099_ses-T2,358,360,0.994444444,2,4,0.066666667,0.5,94
sub-2100_ses-T1,175,180,0.972222222,5,10,0.166666667,0.5,95
sub-2100_ses-T2,347,360,0.963888889,13,26,0.433333333,0.5,96
sub-2101_ses-T1,354,360,0.983333333,6,12,0.2,0.5,97
sub-2101_ses-T2,349,360,0.969444444,11,22,0.366666667,0.5,98
sub-2102_ses-T1,358,360,0.994444444,2,4,0.066666667,0.5,99
sub-2103_ses-T1,350,360,0.972222222,10,20,0.333333333,0.5,100
sub-2103_ses-T2,358,360,0.994444444,2,4,0.066666667,0.5,101
sub-2104_ses-T1,382,387,0.987080103,5,10,0.166666667,0.5,102
sub-2105_ses-T1,358,360,0.994444444,2,4,0.066666667,0.5,103
sub-2105_ses-T2,358,360,0.994444444,2,4,0.066666667,0.5,104
sub-2106_ses-T1,358,360,0.994444444,2,4,0.066666667,0.5,105
sub-2107_ses-T1,335,360,0.930555556,25,50,0.833333333,0.5,106
sub-2107_ses-T2,339,360,0.941666667,21,42,0.7,0.5,107
sub-2108_ses-T1,358,360,0.994444444,2,4,0.066666667,0.5,108
sub-2108_ses-T3,138,141,0.978723404,3,6,0.1,0.5,109
sub-2109_ses-T1,177,180,0.983333333,3,6,0.1,0.5,110
sub-2110_ses-T1,271,274,0.989051095,3,6,0.1,0.5,111
sub-2115_ses-T1,358,360,0.994444444,2,4,0.066666667,0.5,112
sub-2115_ses-T2,358,360,0.994444444,2,4,0.066666667,0.5,113
sub-2117_ses-T1,358,360,0.994444444,2,4,0.066666667,0.5,114
sub-2117_ses-T2,348,360,0.966666667,12,24,0.4,0.5,115
sub-2118_ses-T1,351,360,0.975,9,18,0.3,0.5,116
sub-2120_ses-T1,357,360,0.991666667,3,6,0.1,0.5,117
sub-2122_ses-T1,356,360,0.988888889,4,8,0.133333333,0.5,118
sub-2123_ses-T1,359,360,0.997222222,1,2,0.033333333,0.5,119
sub-2124_ses-T1,349,404,0.863861386,55,110,1.833333333,0.5,120
sub-2126_ses-T1,358,360,0.994444444,2,4,0.066666667,0.5,121
sub-2128_ses-T1,358,360,0.994444444,2,4,0.066666667,0.5,122
sub-2133_ses-T1,355,360,0.986111111,5,10,0.166666667,0.5,123
sub-2135_ses-T1,8,19,0.421052632,11,22,0.366666667,0.5,124
sub-2136_ses-T1,703,720,0.976388889,17,34,0.566666667,0.5,125
sub-2137_ses-T1,709,720,0.984722222,11,22,0.366666667,0.5,126
sub-2137_ses-T2,277,360,0.769444444,83,166,2.766666667,0.5,127
sub-2138_ses-T1,359,360,0.997222222,1,2,0.033333333,0.5,128
sub-2139_ses-T1,340,360,0.944444444,20,40,0.666666667,0.5,129
sub-2140_ses-T1,377,379,0.994722955,2,4,0.066666667,0.5,130
sub-2141_ses-T1,345,360,0.958333333,15,30,0.5,0.5,131
sub-2142_ses-T2,359,360,0.997222222,1,2,0.033333333,0.5,132
sub-2143_ses-T1,355,360,0.986111111,5,10,0.166666667,0.5,133
sub-2144_ses-T1,361,372,0.970430108,11,22,0.366666667,0.5,134
sub-2145_ses-T1,353,360,0.980555556,7,14,0.233333333,0.5,135
sub-2145_ses-T2,340,360,0.944444444,20,40,0.666666667,0.5,136
sub-2146_ses-T1,358,360,0.994444444,2,4,0.066666667,0.5,137
sub-2146_ses-T2,712,720,0.988888889,8,16,0.266666667,0.5,138
sub-2147_ses-T1,357,360,0.991666667,3,6,0.1,0.5,139
sub-2147_ses-T2,358,360,0.994444444,2,4,0.066666667,0.5,140
sub-2148_ses-T1,396,399,0.992481203,3,6,0.1,0.5,141
sub-2149_ses-T1,355,360,0.986111111,5,10,0.166666667,0.5,142
sub-2150_ses-T1,359,360,0.997222222,1,2,0.033333333,0.5,143
sub-2150_ses-T2,355,360,0.986111111,5,10,0.166666667,0.5,144
sub-2151_ses-T1,712,720,0.988888889,8,16,0.266666667,0.5,145
sub-2151_ses-T2,762,773,0.985769728,11,22,0.366666667,0.5,146
sub-2152_ses-T1,359,360,0.997222222,1,2,0.033333333,0.5,147
sub-2152_ses-T2,356,360,0.988888889,4,8,0.133333333,0.5,148
sub-2153_ses-T1,380,383,0.992167102,3,6,0.1,0.5,149
sub-2154_ses-T2,359,360,0.997222222,1,2,0.033333333,0.5,150
sub-2155_ses-T1,359,360,0.997222222,1,2,0.033333333,0.5,151
sub-2156_ses-T1,349,360,0.969444444,11,22,0.366666667,0.5,152
sub-2157_ses-T1,359,360,0.997222222,1,2,0.033333333,0.5,153
sub-2158_ses-T1,355,360,0.986111111,5,10,0.166666667,0.5,154
sub-2159_ses-T1,354,360,0.983333333,6,12,0.2,0.5,155
sub-2160_ses-T1,356,360,0.988888889,4,8,0.133333333,0.5,156
sub-2161_ses-T1,357,360,0.991666667,3,6,0.1,0.5,157
sub-2162_ses-T1,359,360,0.997222222,1,2,0.033333333,0.5,158
sub-2163_ses-T1,394,399,0.987468672,5,10,0.166666667,0.5,159
sub-2164_ses-T1,608,720,0.844444444,112,224,3.733333333,0.5,160
sub-2164_ses-T2,672,720,0.933333333,48,96,1.6,0.5,161
sub-2165_ses-T1,470,481,0.977130977,11,22,0.366666667,0.5,162
sub-2166_ses-T1,358,360,0.994444444,2,4,0.066666667,0.5,163
sub-2166_ses-T2,344,360,0.955555556,16,32,0.533333333,0.5,164
sub-2167_ses-T1,368,370,0.994594595,2,4,0.066666667,0.5,165
sub-2168_ses-T1,359,360,0.997222222,1,2,0.033333333,0.5,166
sub-2168_ses-T2,355,360,0.986111111,5,10,0.166666667,0.5,167
sub-2169_ses-T1,358,360,0.994444444,2,4,0.066666667,0.5,168
sub-2169_ses-T2,352,360,0.977777778,8,16,0.266666667,0.5,169
sub-2170_ses-T1,253,264,0.958333333,11,22,0.366666667,0.5,170
sub-2171_ses-T1,370,374,0.989304813,4,8,0.133333333,0.5,171
sub-2171_ses-T2,446,483,0.923395445,37,74,1.233333333,0.5,172
sub-2171_ses-T3,536,577,0.928942808,41,82,1.366666667,0.5,173
sub-2172_ses-T1,499,513,0.972709552,14,28,0.466666667,0.5,174
sub-2172_ses-T2,382,386,0.989637306,4,8,0.133333333,0.5,175
sub-2173_ses-T1,340,360,0.944444444,20,40,0.666666667,0.5,176
sub-2174_ses-T1,410,416,0.985576923,6,12,0.2,0.5,177
sub-2175_ses-T1,676,679,0.995581738,3,6,0.1,0.5,178
sub-2176_ses-T1,320,360,0.888888889,40,80,1.333333333,0.5,179
sub-2176_ses-T2,256,360,0.711111111,104,208,3.466666667,0.5,180
sub-2177_ses-T1,690,695,0.992805755,5,10,0.166666667,0.5,181
sub-2177_ses-T2,733,736,0.995923913,3,6,0.1,0.5,182
sub-2178_ses-T2,357,360,0.991666667,3,6,0.1,0.5,183
sub-2179_ses-T2,712,720,0.988888889,8,16,0.266666667,0.5,184
sub-2180_ses-T1,342,360,0.95,18,36,0.6,0.5,185
sub-2180_ses-T2,267,360,0.741666667,93,186,3.1,0.5,186
sub-2181_ses-T1,358,360,0.994444444,2,4,0.066666667,0.5,187
sub-2182_ses-T1,49,51,0.960784314,2,4,0.066666667,0.5,188
sub-2184_ses-T1,388,391,0.992327366,3,6,0.1,0.5,189
sub-2185_ses-T1,358,360,0.994444444,2,4,0.066666667,0.5,190
sub-2186_ses-T1,360,371,0.970350404,11,22,0.366666667,0.5,191
sub-2187_ses-T1,46,48,0.958333333,2,4,0.066666667,0.5,192
sub-2188_ses-T1,439,445,0.986516854,6,12,0.2,0.5,193
sub-2189_ses-T1,200,204,0.980392157,4,8,0.133333333,0.5,194
sub-2190_ses-T1,356,360,0.988888889,4,8,0.133333333,0.5,195
sub-2191_ses-T1,359,360,0.997222222,1,2,0.033333333,0.5,196
sub-2191_ses-T2,351,360,0.975,9,18,0.3,0.5,197
sub-2192_ses-T1,359,360,0.997222222,1,2,0.033333333,0.5,198
sub-2193_ses-T2,618,625,0.9888,7,14,0.233333333,0.5,199
sub-2194_ses-T1,411,415,0.990361446,4,8,0.133333333,0.5,200
sub-2195_ses-T1,247,360,0.686111111,113,226,3.766666667,0.5,201
sub-2196_ses-T1,394,416,0.947115385,22,44,0.733333333,0.5,202
sub-2197_ses-T1,434,439,0.988610478,5,10,0.166666667,0.5,203
sub-2197_ses-T2,372,384,0.96875,12,24,0.4,0.5,204
sub-2198_ses-T1,402,407,0.987714988,5,10,0.166666667,0.5,205
sub-2199_ses-T1,402,404,0.995049505,2,4,0.066666667,0.5,206
sub-2200_ses-T1,359,360,0.997222222,1,2,0.033333333,0.5,207
sub-2201_ses-T1,359,360,0.997222222,1,2,0.033333333,0.5,208
sub-2202_ses-T1,587,606,0.968646865,19,38,0.633333333,0.5,209
sub-2203_ses-T1,358,360,0.994444444,2,4,0.066666667,0.5,210
sub-2204_ses-T1,356,360,0.988888889,4,8,0.133333333,0.5,211
sub-2204_ses-T2,359,360,0.997222222,1,2,0.033333333,0.5,212
sub-2205_ses-T1,359,360,0.997222222,1,2,0.033333333,0.5,213
sub-2206_ses-T1,359,360,0.997222222,1,2,0.033333333,0.5,214
sub-2206_ses-T2,706,720,0.980555556,14,28,0.466666667,0.5,215
sub-2207_ses-T1,339,360,0.941666667,21,42,0.7,0.5,216
sub-2207_ses-T2,350,360,0.972222222,10,20,0.333333333,0.5,217
sub-2208_ses-T1,353,360,0.980555556,7,14,0.233333333,0.5,218
sub-2208_ses-T2,348,360,0.966666667,12,24,0.4,0.5,219
sub-2209_ses-T1,338,341,0.991202346,3,6,0.1,0.5,220
sub-2210_ses-T1,34,38,0.894736842,4,8,0.133333333,0.5,221
sub-2211_ses-T1,359,360,0.997222222,1,2,0.033333333,0.5,222
sub-2212_ses-T1,359,360,0.997222222,1,2,0.033333333,0.5,223
sub-2213_ses-T1,281,286,0.982517483,5,10,0.166666667,0.5,224
sub-2214_ses-T1,371,373,0.99463807,2,4,0.066666667,0.5,225
sub-2215_ses-T1,359,360,0.997222222,1,2,0.033333333,0.5,226
sub-2216_ses-T1,79,86,0.918604651,7,14,0.233333333,0.5,227
sub-2216_ses-T2,159,181,0.878453039,22,44,0.733333333,0.5,228
sub-2217_ses-T1,339,360,0.941666667,21,42,0.7,0.5,229
sub-2217_ses-T2,205,360,0.569444444,155,310,5.166666667,0.5,230
sub-2218_ses-T1,356,360,0.988888889,4,8,0.133333333,0.5,231
sub-2218_ses-T2,684,720,0.95,36,72,1.2,0.5,232
sub-2219_ses-T1,359,360,0.997222222,1,2,0.033333333,0.5,233
sub-2220_ses-T1,359,360,0.997222222,1,2,0.033333333,0.5,234
sub-2220_ses-T2,710,720,0.986111111,10,20,0.333333333,0.5,235
sub-2221_ses-T1,349,360,0.969444444,11,22,0.366666667,0.5,236
sub-2221_ses-T2,708,720,0.983333333,12,24,0.4,0.5,237
sub-2222_ses-T1,354,360,0.983333333,6,12,0.2,0.5,238
sub-2223_ses-T1,358,360,0.994444444,2,4,0.066666667,0.5,239
sub-2223_ses-T2,696,720,0.966666667,24,48,0.8,0.5,240
sub-2224_ses-T1,364,379,0.960422164,15,30,0.5,0.5,241
sub-2225_ses-T1,358,360,0.994444444,2,4,0.066666667,0.5,242
sub-2225_ses-T2,747,759,0.984189723,12,24,0.4,0.5,243
sub-2226_ses-T1,353,365,0.967123288,12,24,0.4,0.5,244
sub-2226_ses-T2,344,360,0.955555556,16,32,0.533333333,0.5,245
sub-2227_ses-T1,359,360,0.997222222,1,2,0.033333333,0.5,246
sub-2228_ses-T1,359,360,0.997222222,1,2,0.033333333,0.5,247
sub-2228_ses-T2,717,729,0.983539095,12,24,0.4,0.5,248
sub-2229_ses-T1,359,360,0.997222222,1,2,0.033333333,0.5,249
sub-2229_ses-T2,384,390,0.984615385,6,12,0.2,0.5,250
sub-2230_ses-T1,395,398,0.992462312,3,6,0.1,0.5,251
sub-7001_ses-f2,626,720,0.869444444,94,188,3.133333333,0.5,252
sub-7001_ses-f3,343,720,0.476388889,377,754,12.56666667,0.5,253
sub-7002_ses-f1,707,720,0.981944444,13,26,0.433333333,0.5,254
sub-7002_ses-f2,693,720,0.9625,27,54,0.9,0.5,255
sub-7003_ses-f1,357,360,0.991666667,3,6,0.1,0.5,256
sub-7003_ses-f2,131,180,0.727777778,49,98,1.633333333,0.5,257
sub-7004_ses-f3,677,724,0.935082873,47,94,1.566666667,0.5,258
sub-7006_ses-f1,48,52,0.923076923,4,8,0.133333333,0.5,259
sub-7008_ses-f1,709,720,0.984722222,11,22,0.366666667,0.5,260
sub-7008_ses-f2,524,720,0.727777778,196,392,6.533333333,0.5,261
sub-7009_ses-f1,704,720,0.977777778,16,32,0.533333333,0.5,262
sub-7009_ses-f2,628,720,0.872222222,92,184,3.066666667,0.5,263
sub-7011_ses-f1,913,917,0.99563795,4,8,0.133333333,0.5,264
sub-7011_ses-f2,355,360,0.986111111,5,10,0.166666667,0.5,265
sub-7012_ses-f1,756,761,0.993429698,5,10,0.166666667,0.5,266
sub-7012_ses-f2,711,720,0.9875,9,18,0.3,0.5,267
sub-7014_ses-f1,353,360,0.980555556,7,14,0.233333333,0.5,268
sub-7014_ses-f2,717,720,0.995833333,3,6,0.1,0.5,269
sub-7015_ses-f1,798,832,0.959134615,34,68,1.133333333,0.5,270
sub-7015_ses-f2,715,729,0.98079561,14,28,0.466666667,0.5,271
sub-7016_ses-f1,742,750,0.989333333,8,16,0.266666667,0.5,272
sub-7016_ses-f2,534,720,0.741666667,186,372,6.2,0.5,273
sub-7017_ses-f1,736,740,0.994594595,4,8,0.133333333,0.5,274
sub-7017_ses-f2,722,725,0.995862069,3,6,0.1,0.5,275
sub-7020_ses-f1,731,740,0.987837838,9,18,0.3,0.5,276
sub-7020_ses-f2,658,720,0.913888889,62,124,2.066666667,0.5,277
sub-7021_ses-f1,749,753,0.994687915,4,8,0.133333333,0.5,278
sub-7022_ses-f1,718,720,0.997222222,2,4,0.066666667,0.5,279
sub-7022_ses-f2,724,727,0.995873453,3,6,0.1,0.5,280
sub-7023_ses-f1,735,744,0.987903226,9,18,0.3,0.5,281
sub-7023_ses-f2,817,829,0.985524729,12,24,0.4,0.5,282
sub-7024_ses-f1,724,728,0.994505495,4,8,0.133333333,0.5,283
sub-7025_ses-f1,722,729,0.990397805,7,14,0.233333333,0.5,284
sub-7025_ses-f2,705,760,0.927631579,55,110,1.833333333,0.5,285
sub-7026_ses-f1,905,920,0.983695652,15,30,0.5,0.5,286
sub-7026_ses-f2,911,914,0.996717724,3,6,0.1,0.5,287
sub-7026_ses-f3,633,731,0.865937073,98,196,3.266666667,0.5,288
sub-7027_ses-f1,881,885,0.995480226,4,8,0.133333333,0.5,289
sub-7027_ses-f2,390,410,0.951219512,20,40,0.666666667,0.5,290
sub-7027_ses-f3,693,725,0.955862069,32,64,1.066666667,0.5,291
sub-7028_ses-f1,749,752,0.996010638,3,6,0.1,0.5,292
sub-7028_ses-f2,718,720,0.997222222,2,4,0.066666667,0.5,293
sub-7029_ses-f1,724,731,0.990424077,7,14,0.233333333,0.5,294
sub-7029_ses-f2,702,725,0.968275862,23,46,0.766666667,0.5,295
sub-7030_ses-f1,655,720,0.909722222,65,130,2.166666667,0.5,296
sub-7030_ses-f2,749,794,0.943324937,45,90,1.5,0.5,297
sub-7031_ses-f1,136,192,0.708333333,56,112,1.866666667,0.5,298
sub-7031_ses-f2,305,374,0.815508021,69,138,2.3,0.5,299
sub-7031_ses-f3,726,737,0.985074627,11,22,0.366666667,0.5,300
sub-7032_ses-f1,718,720,0.997222222,2,4,0.066666667,0.5,301
sub-7032_ses-f2,69,73,0.945205479,4,8,0.133333333,0.5,302
sub-7032_ses-f3,734,740,0.991891892,6,12,0.2,0.5,303
sub-7033_ses-f2,653,752,0.868351064,99,198,3.3,0.5,304
sub-7034_ses-f1,751,760,0.988157895,9,18,0.3,0.5,305
sub-7034_ses-f2,890,912,0.975877193,22,44,0.733333333,0.5,306
sub-7034_ses-f3,648,728,0.89010989,80,160,2.666666667,0.5,307
sub-7035_ses-f1,44,50,0.88,6,12,0.2,0.5,308
sub-7035_ses-f2,699,727,0.961485557,28,56,0.933333333,0.5,309
sub-7036_ses-f1,726,745,0.974496644,19,38,0.633333333,0.5,310
sub-7037_ses-f1,769,772,0.99611399,3,6,0.1,0.5,311
sub-7037_ses-f2,845,852,0.991784038,7,14,0.233333333,0.5,312
sub-7037_ses-f3,713,720,0.990277778,7,14,0.233333333,0.5,313
sub-7038_ses-f1,769,789,0.974651458,20,40,0.666666667,0.5,314
sub-7038_ses-f2,667,785,0.849681529,118,236,3.933333333,0.5,315
sub-7039_ses-f1,757,785,0.96433121,28,56,0.933333333,0.5,316
sub-7039_ses-f2,697,727,0.958734525,30,60,1,0.5,317
sub-7040_ses-f1,696,728,0.956043956,32,64,1.066666667,0.5,318
sub-7040_ses-f2,682,720,0.947222222,38,76,1.266666667,0.5,319
sub-7040_ses-f3,658,720,0.913888889,62,124,2.066666667,0.5,320
sub-7041_ses-f1,748,754,0.99204244,6,12,0.2,0.5,321
sub-7041_ses-f2,695,735,0.945578231,40,80,1.333333333,0.5,322
sub-7042_ses-f3,622,658,0.945288754,36,72,1.2,0.5,323
sub-7043_ses-f2,1030,1080,0.953703704,50,100,1.666666667,0.5,324
sub-7044_ses-f2,726,739,0.98240866,13,26,0.433333333,0.5,325
sub-7045_ses-f1,802,823,0.974483597,21,42,0.7,0.5,326
sub-7046_ses-f1,805,812,0.99137931,7,14,0.233333333,0.5,327
sub-7046_ses-f2,47,61,0.770491803,14,28,0.466666667,0.5,328
sub-7046_ses-f3,720,741,0.971659919,21,42,0.7,0.5,329
sub-7047_ses-f1,718,720,0.997222222,2,4,0.066666667,0.5,330
sub-7047_ses-f2,49,64,0.765625,15,30,0.5,0.5,331
sub-7048_ses-f1,5,6,0.833333333,1,2,0.033333333,0.5,332
sub-7048_ses-f2,354,360,0.983333333,6,12,0.2,0.5,333
sub-7049_ses-f1,355,360,0.986111111,5,10,0.166666667,0.5,334
sub-7052_ses-f1,509,518,0.982625483,9,18,0.3,0.5,335
sub-7053_ses-f1,714,720,0.991666667,6,12,0.2,0.5,336
sub-7054_ses-f1,718,766,0.937336815,48,96,1.6,0.5,337
sub-2006_ses-T1,381,420,0.907142857,39,78,1.3,0.6,1
sub-2011_ses-T1,347,360,0.963888889,13,26,0.433333333,0.6,2
sub-2012_ses-T1,179,180,0.994444444,1,2,0.033333333,0.6,3
sub-2013_ses-T1,347,360,0.963888889,13,26,0.433333333,0.6,4
sub-2014_ses-T1,353,360,0.980555556,7,14,0.233333333,0.6,5
sub-2015_ses-T1,126,180,0.7,54,108,1.8,0.6,6
sub-2016_ses-T1,356,360,0.988888889,4,8,0.133333333,0.6,7
sub-2017_ses-T1,179,180,0.994444444,1,2,0.033333333,0.6,8
sub-2018_ses-T1,173,180,0.961111111,7,14,0.233333333,0.6,9
sub-2019_ses-T1,357,360,0.991666667,3,6,0.1,0.6,10
sub-2020_ses-T1,19,26,0.730769231,7,14,0.233333333,0.6,11
sub-2020_ses-T2,343,360,0.952777778,17,34,0.566666667,0.6,12
sub-2021_ses-T1,352,360,0.977777778,8,16,0.266666667,0.6,13
sub-2022_ses-T1,340,360,0.944444444,20,40,0.666666667,0.6,14
sub-2023_ses-T1,239,360,0.663888889,121,242,4.033333333,0.6,15
sub-2024_ses-T2,11,12,0.916666667,1,2,0.033333333,0.6,16
sub-2026_ses-T1,219,223,0.98206278,4,8,0.133333333,0.6,17
sub-2027_ses-T1,358,360,0.994444444,2,4,0.066666667,0.6,18
sub-2028_ses-T1,332,360,0.922222222,28,56,0.933333333,0.6,19
sub-2029_ses-T1,354,360,0.983333333,6,12,0.2,0.6,20
sub-2030_ses-T1,332,360,0.922222222,28,56,0.933333333,0.6,21
sub-2031_ses-T1,358,360,0.994444444,2,4,0.066666667,0.6,22
sub-2032_ses-T1,319,360,0.886111111,41,82,1.366666667,0.6,23
sub-2033_ses-T1,357,360,0.991666667,3,6,0.1,0.6,24
sub-2033_ses-T2,273,360,0.758333333,87,174,2.9,0.6,25
sub-2034_ses-T1,145,180,0.805555556,35,70,1.166666667,0.6,26
sub-2035_ses-T1,358,360,0.994444444,2,4,0.066666667,0.6,27
sub-2036_ses-T1,357,360,0.991666667,3,6,0.1,0.6,28
sub-2037_ses-T1,355,360,0.986111111,5,10,0.166666667,0.6,29
sub-2038_ses-T1,358,360,0.994444444,2,4,0.066666667,0.6,30
sub-2039_ses-T1,179,180,0.994444444,1,2,0.033333333,0.6,31
sub-2040_ses-T1,358,360,0.994444444,2,4,0.066666667,0.6,32
sub-2041_ses-T1,358,360,0.994444444,2,4,0.066666667,0.6,33
sub-2042_ses-T1,177,180,0.983333333,3,6,0.1,0.6,34
sub-2043_ses-T1,288,360,0.8,72,144,2.4,0.6,35
sub-2044_ses-T1,328,360,0.911111111,32,64,1.066666667,0.6,36
sub-2045_ses-T1,163,180,0.905555556,17,34,0.566666667,0.6,37
sub-2046_ses-T1,176,180,0.977777778,4,8,0.133333333,0.6,38
sub-2047_ses-T1,174,180,0.966666667,6,12,0.2,0.6,39
sub-2048_ses-T1,177,180,0.983333333,3,6,0.1,0.6,40
sub-2049_ses-T1,355,360,0.986111111,5,10,0.166666667,0.6,41
sub-2051_ses-T1,358,360,0.994444444,2,4,0.066666667,0.6,42
sub-2051_ses-T2,358,360,0.994444444,2,4,0.066666667,0.6,43
sub-2052_ses-T1,343,360,0.952777778,17,34,0.566666667,0.6,44
sub-2052_ses-T2,151,180,0.838888889,29,58,0.966666667,0.6,45
sub-2053_ses-T1,321,360,0.891666667,39,78,1.3,0.6,46
sub-2055_ses-T1,141,180,0.783333333,39,78,1.3,0.6,47
sub-2056_ses-T1,358,360,0.994444444,2,4,0.066666667,0.6,48
sub-2057_ses-T1,358,360,0.994444444,2,4,0.066666667,0.6,49
sub-2058_ses-T1,296,360,0.822222222,64,128,2.133333333,0.6,50
sub-2059_ses-T1,283,360,0.786111111,77,154,2.566666667,0.6,51
sub-2061_ses-T1,161,180,0.894444444,19,38,0.633333333,0.6,52
sub-2062_ses-T1,357,360,0.991666667,3,6,0.1,0.6,53
sub-2063_ses-T1,350,360,0.972222222,10,20,0.333333333,0.6,54
sub-2064_ses-T1,177,180,0.983333333,3,6,0.1,0.6,55
sub-2065_ses-T1,157,180,0.872222222,23,46,0.766666667,0.6,56
sub-2066_ses-T1,177,180,0.983333333,3,6,0.1,0.6,57
sub-2066_ses-T2,357,360,0.991666667,3,6,0.1,0.6,58
sub-2067_ses-T1,357,360,0.991666667,3,6,0.1,0.6,59
sub-2068_ses-T1,358,360,0.994444444,2,4,0.066666667,0.6,60
sub-2069_ses-T1,351,360,0.975,9,18,0.3,0.6,61
sub-2070_ses-T1,349,360,0.969444444,11,22,0.366666667,0.6,62
sub-2071_ses-T1,353,360,0.980555556,7,14,0.233333333,0.6,63
sub-2072_ses-T1,358,360,0.994444444,2,4,0.066666667,0.6,64
sub-2073_ses-T1,254,256,0.9921875,2,4,0.066666667,0.6,65
sub-2073_ses-T2,166,180,0.922222222,14,28,0.466666667,0.6,66
sub-2074_ses-T1,171,180,0.95,9,18,0.3,0.6,67
sub-2075_ses-T1,179,180,0.994444444,1,2,0.033333333,0.6,68
sub-2076_ses-T1,339,360,0.941666667,21,42,0.7,0.6,69
sub-2076_ses-T2,310,360,0.861111111,50,100,1.666666667,0.6,70
sub-2077_ses-T1,358,360,0.994444444,2,4,0.066666667,0.6,71
sub-2078_ses-T1,358,360,0.994444444,2,4,0.066666667,0.6,72
sub-2079_ses-T1,355,360,0.986111111,5,10,0.166666667,0.6,73
sub-2079_ses-T2,317,360,0.880555556,43,86,1.433333333,0.6,74
sub-2080_ses-T1,304,360,0.844444444,56,112,1.866666667,0.6,75
sub-2081_ses-T1,357,360,0.991666667,3,6,0.1,0.6,76
sub-2082_ses-T1,343,360,0.952777778,17,34,0.566666667,0.6,77
sub-2083_ses-T1,307,360,0.852777778,53,106,1.766666667,0.6,78
sub-2084_ses-T1,358,360,0.994444444,2,4,0.066666667,0.6,79
sub-2085_ses-T1,351,360,0.975,9,18,0.3,0.6,80
sub-2086_ses-T1,282,360,0.783333333,78,156,2.6,0.6,81
sub-2087_ses-T1,355,360,0.986111111,5,10,0.166666667,0.6,82
sub-2088_ses-T1,355,360,0.986111111,5,10,0.166666667,0.6,83
sub-2089_ses-T1,179,180,0.994444444,1,2,0.033333333,0.6,84
sub-2091_ses-T1,324,360,0.9,36,72,1.2,0.6,85
sub-2092_ses-T1,352,360,0.977777778,8,16,0.266666667,0.6,86
sub-2093_ses-T1,355,360,0.986111111,5,10,0.166666667,0.6,87
sub-2094_ses-T1,173,180,0.961111111,7,14,0.233333333,0.6,88
sub-2095_ses-T1,357,360,0.991666667,3,6,0.1,0.6,89
sub-2096_ses-T1,349,360,0.969444444,11,22,0.366666667,0.6,90
sub-2097_ses-T1,535,540,0.990740741,5,10,0.166666667,0.6,91
sub-2098_ses-T1,311,360,0.863888889,49,98,1.633333333,0.6,92
sub-2099_ses-T1,178,180,0.988888889,2,4,0.066666667,0.6,93
sub-2099_ses-T2,356,360,0.988888889,4,8,0.133333333,0.6,94
sub-2100_ses-T1,175,180,0.972222222,5,10,0.166666667,0.6,95
sub-2100_ses-T2,341,360,0.947222222,19,38,0.633333333,0.6,96
sub-2101_ses-T1,349,360,0.969444444,11,22,0.366666667,0.6,97
sub-2101_ses-T2,336,360,0.933333333,24,48,0.8,0.6,98
sub-2102_ses-T1,358,360,0.994444444,2,4,0.066666667,0.6,99
sub-2103_ses-T1,346,360,0.961111111,14,28,0.466666667,0.6,100
sub-2103_ses-T2,358,360,0.994444444,2,4,0.066666667,0.6,101
sub-2104_ses-T1,382,387,0.987080103,5,10,0.166666667,0.6,102
sub-2105_ses-T1,358,360,0.994444444,2,4,0.066666667,0.6,103
sub-2105_ses-T2,357,360,0.991666667,3,6,0.1,0.6,104
sub-2106_ses-T1,358,360,0.994444444,2,4,0.066666667,0.6,105
sub-2107_ses-T1,320,360,0.888888889,40,80,1.333333333,0.6,106
sub-2107_ses-T2,327,360,0.908333333,33,66,1.1,0.6,107
sub-2108_ses-T1,358,360,0.994444444,2,4,0.066666667,0.6,108
sub-2108_ses-T3,138,141,0.978723404,3,6,0.1,0.6,109
sub-2109_ses-T1,177,180,0.983333333,3,6,0.1,0.6,110
sub-2110_ses-T1,270,274,0.98540146,4,8,0.133333333,0.6,111
sub-2115_ses-T1,358,360,0.994444444,2,4,0.066666667,0.6,112
sub-2115_ses-T2,357,360,0.991666667,3,6,0.1,0.6,113
sub-2117_ses-T1,357,360,0.991666667,3,6,0.1,0.6,114
sub-2117_ses-T2,338,360,0.938888889,22,44,0.733333333,0.6,115
sub-2118_ses-T1,344,360,0.955555556,16,32,0.533333333,0.6,116
sub-2120_ses-T1,356,360,0.988888889,4,8,0.133333333,0.6,117
sub-2122_ses-T1,354,360,0.983333333,6,12,0.2,0.6,118
sub-2123_ses-T1,357,360,0.991666667,3,6,0.1,0.6,119
sub-2124_ses-T1,349,404,0.863861386,55,110,1.833333333,0.6,120
sub-2126_ses-T1,358,360,0.994444444,2,4,0.066666667,0.6,121
sub-2128_ses-T1,358,360,0.994444444,2,4,0.066666667,0.6,122
sub-2133_ses-T1,349,360,0.969444444,11,22,0.366666667,0.6,123
sub-2135_ses-T1,8,19,0.421052632,11,22,0.366666667,0.6,124
sub-2136_ses-T1,690,720,0.958333333,30,60,1,0.6,125
sub-2137_ses-T1,701,720,0.973611111,19,38,0.633333333,0.6,126
sub-2137_ses-T2,242,360,0.672222222,118,236,3.933333333,0.6,127
sub-2138_ses-T1,359,360,0.997222222,1,2,0.033333333,0.6,128
sub-2139_ses-T1,321,360,0.891666667,39,78,1.3,0.6,129
sub-2140_ses-T1,377,379,0.994722955,2,4,0.066666667,0.6,130
sub-2141_ses-T1,339,360,0.941666667,21,42,0.7,0.6,131
sub-2142_ses-T2,359,360,0.997222222,1,2,0.033333333,0.6,132
sub-2143_ses-T1,348,360,0.966666667,12,24,0.4,0.6,133
sub-2144_ses-T1,352,372,0.946236559,20,40,0.666666667,0.6,134
sub-2145_ses-T1,348,360,0.966666667,12,24,0.4,0.6,135
sub-2145_ses-T2,323,360,0.897222222,37,74,1.233333333,0.6,136
sub-2146_ses-T1,358,360,0.994444444,2,4,0.066666667,0.6,137
sub-2146_ses-T2,694,720,0.963888889,26,52,0.866666667,0.6,138
sub-2147_ses-T1,354,360,0.983333333,6,12,0.2,0.6,139
sub-2147_ses-T2,356,360,0.988888889,4,8,0.133333333,0.6,140
sub-2148_ses-T1,396,399,0.992481203,3,6,0.1,0.6,141
sub-2149_ses-T1,353,360,0.980555556,7,14,0.233333333,0.6,142
sub-2150_ses-T1,359,360,0.997222222,1,2,0.033333333,0.6,143
sub-2150_ses-T2,354,360,0.983333333,6,12,0.2,0.6,144
sub-2151_ses-T1,706,720,0.980555556,14,28,0.466666667,0.6,145
sub-2151_ses-T2,753,773,0.974126779,20,40,0.666666667,0.6,146
sub-2152_ses-T1,359,360,0.997222222,1,2,0.033333333,0.6,147
sub-2152_ses-T2,352,360,0.977777778,8,16,0.266666667,0.6,148
sub-2153_ses-T1,379,383,0.989556136,4,8,0.133333333,0.6,149
sub-2154_ses-T2,359,360,0.997222222,1,2,0.033333333,0.6,150
sub-2155_ses-T1,359,360,0.997222222,1,2,0.033333333,0.6,151
sub-2156_ses-T1,340,360,0.944444444,20,40,0.666666667,0.6,152
sub-2157_ses-T1,357,360,0.991666667,3,6,0.1,0.6,153
sub-2158_ses-T1,353,360,0.980555556,7,14,0.233333333,0.6,154
sub-2159_ses-T1,349,360,0.969444444,11,22,0.366666667,0.6,155
sub-2160_ses-T1,351,360,0.975,9,18,0.3,0.6,156
sub-2161_ses-T1,357,360,0.991666667,3,6,0.1,0.6,157
sub-2162_ses-T1,358,360,0.994444444,2,4,0.066666667,0.6,158
sub-2163_ses-T1,392,399,0.98245614,7,14,0.233333333,0.6,159
sub-2164_ses-T1,570,720,0.791666667,150,300,5,0.6,160
sub-2164_ses-T2,652,720,0.905555556,68,136,2.266666667,0.6,161
sub-2165_ses-T1,456,481,0.948024948,25,50,0.833333333,0.6,162
sub-2166_ses-T1,358,360,0.994444444,2,4,0.066666667,0.6,163
sub-2166_ses-T2,330,360,0.916666667,30,60,1,0.6,164
sub-2167_ses-T1,368,370,0.994594595,2,4,0.066666667,0.6,165
sub-2168_ses-T1,359,360,0.997222222,1,2,0.033333333,0.6,166
sub-2168_ses-T2,352,360,0.977777778,8,16,0.266666667,0.6,167
sub-2169_ses-T1,358,360,0.994444444,2,4,0.066666667,0.6,168
sub-2169_ses-T2,347,360,0.963888889,13,26,0.433333333,0.6,169
sub-2170_ses-T1,248,264,0.939393939,16,32,0.533333333,0.6,170
sub-2171_ses-T1,369,374,0.986631016,5,10,0.166666667,0.6,171
sub-2171_ses-T2,420,483,0.869565217,63,126,2.1,0.6,172
sub-2171_ses-T3,517,577,0.896013865,60,120,2,0.6,173
sub-2172_ses-T1,484,513,0.943469786,29,58,0.966666667,0.6,174
sub-2172_ses-T2,381,386,0.987046632,5,10,0.166666667,0.6,175
sub-2173_ses-T1,332,360,0.922222222,28,56,0.933333333,0.6,176
sub-2174_ses-T1,405,416,0.973557692,11,22,0.366666667,0.6,177
sub-2175_ses-T1,674,679,0.99263623,5,10,0.166666667,0.6,178
sub-2176_ses-T1,297,360,0.825,63,126,2.1,0.6,179
sub-2176_ses-T2,197,360,0.547222222,163,326,5.433333333,0.6,180
sub-2177_ses-T1,690,695,0.992805755,5,10,0.166666667,0.6,181
sub-2177_ses-T2,733,736,0.995923913,3,6,0.1,0.6,182
sub-2178_ses-T2,354,360,0.983333333,6,12,0.2,0.6,183
sub-2179_ses-T2,708,720,0.983333333,12,24,0.4,0.6,184
sub-2180_ses-T1,329,360,0.913888889,31,62,1.033333333,0.6,185
sub-2180_ses-T2,228,360,0.633333333,132,264,4.4,0.6,186
sub-2181_ses-T1,358,360,0.994444444,2,4,0.066666667,0.6,187
sub-2182_ses-T1,49,51,0.960784314,2,4,0.066666667,0.6,188
sub-2184_ses-T1,386,391,0.987212276,5,10,0.166666667,0.6,189
sub-2185_ses-T1,357,360,0.991666667,3,6,0.1,0.6,190
sub-2186_ses-T1,353,371,0.95148248,18,36,0.6,0.6,191
sub-2187_ses-T1,46,48,0.958333333,2,4,0.066666667,0.6,192
sub-2188_ses-T1,438,445,0.984269663,7,14,0.233333333,0.6,193
sub-2189_ses-T1,200,204,0.980392157,4,8,0.133333333,0.6,194
sub-2190_ses-T1,350,360,0.972222222,10,20,0.333333333,0.6,195
sub-2191_ses-T1,359,360,0.997222222,1,2,0.033333333,0.6,196
sub-2191_ses-T2,336,360,0.933333333,24,48,0.8,0.6,197
sub-2192_ses-T1,359,360,0.997222222,1,2,0.033333333,0.6,198
sub-2193_ses-T2,618,625,0.9888,7,14,0.233333333,0.6,199
sub-2194_ses-T1,411,415,0.990361446,4,8,0.133333333,0.6,200
sub-2195_ses-T1,218,360,0.605555556,142,284,4.733333333,0.6,201
sub-2196_ses-T1,384,416,0.923076923,32,64,1.066666667,0.6,202
sub-2197_ses-T1,431,439,0.981776765,8,16,0.266666667,0.6,203
sub-2197_ses-T2,365,384,0.950520833,19,38,0.633333333,0.6,204
sub-2198_ses-T1,401,407,0.985257985,6,12,0.2,0.6,205
sub-2199_ses-T1,401,404,0.992574257,3,6,0.1,0.6,206
sub-2200_ses-T1,356,360,0.988888889,4,8,0.133333333,0.6,207
sub-2201_ses-T1,359,360,0.997222222,1,2,0.033333333,0.6,208
sub-2202_ses-T1,581,606,0.958745875,25,50,0.833333333,0.6,209
sub-2203_ses-T1,352,360,0.977777778,8,16,0.266666667,0.6,210
sub-2204_ses-T1,354,360,0.983333333,6,12,0.2,0.6,211
sub-2204_ses-T2,359,360,0.997222222,1,2,0.033333333,0.6,212
sub-2205_ses-T1,357,360,0.991666667,3,6,0.1,0.6,213
sub-2206_ses-T1,358,360,0.994444444,2,4,0.066666667,0.6,214
sub-2206_ses-T2,692,720,0.961111111,28,56,0.933333333,0.6,215
sub-2207_ses-T1,324,360,0.9,36,72,1.2,0.6,216
sub-2207_ses-T2,341,360,0.947222222,19,38,0.633333333,0.6,217
sub-2208_ses-T1,353,360,0.980555556,7,14,0.233333333,0.6,218
sub-2208_ses-T2,340,360,0.944444444,20,40,0.666666667,0.6,219
sub-2209_ses-T1,337,341,0.988269795,4,8,0.133333333,0.6,220
sub-2210_ses-T1,34,38,0.894736842,4,8,0.133333333,0.6,221
sub-2211_ses-T1,359,360,0.997222222,1,2,0.033333333,0.6,222
sub-2212_ses-T1,359,360,0.997222222,1,2,0.033333333,0.6,223
sub-2213_ses-T1,276,286,0.965034965,10,20,0.333333333,0.6,224
sub-2214_ses-T1,371,373,0.99463807,2,4,0.066666667,0.6,225
sub-2215_ses-T1,359,360,0.997222222,1,2,0.033333333,0.6,226
sub-2216_ses-T1,76,86,0.88372093,10,20,0.333333333,0.6,227
sub-2216_ses-T2,153,181,0.845303867,28,56,0.933333333,0.6,228
sub-2217_ses-T1,325,360,0.902777778,35,70,1.166666667,0.6,229
sub-2217_ses-T2,166,360,0.461111111,194,388,6.466666667,0.6,230
sub-2218_ses-T1,355,360,0.986111111,5,10,0.166666667,0.6,231
sub-2218_ses-T2,650,720,0.902777778,70,140,2.333333333,0.6,232
sub-2219_ses-T1,359,360,0.997222222,1,2,0.033333333,0.6,233
sub-2220_ses-T1,358,360,0.994444444,2,4,0.066666667,0.6,234
sub-2220_ses-T2,702,720,0.975,18,36,0.6,0.6,235
sub-2221_ses-T1,336,360,0.933333333,24,48,0.8,0.6,236
sub-2221_ses-T2,696,720,0.966666667,24,48,0.8,0.6,237
sub-2222_ses-T1,344,360,0.955555556,16,32,0.533333333,0.6,238
sub-2223_ses-T1,358,360,0.994444444,2,4,0.066666667,0.6,239
sub-2223_ses-T2,680,720,0.944444444,40,80,1.333333333,0.6,240
sub-2224_ses-T1,360,379,0.949868074,19,38,0.633333333,0.6,241
sub-2225_ses-T1,358,360,0.994444444,2,4,0.066666667,0.6,242
sub-2225_ses-T2,741,759,0.976284585,18,36,0.6,0.6,243
sub-2226_ses-T1,344,365,0.942465753,21,42,0.7,0.6,244
sub-2226_ses-T2,335,360,0.930555556,25,50,0.833333333,0.6,245
sub-2227_ses-T1,359,360,0.997222222,1,2,0.033333333,0.6,246
sub-2228_ses-T1,359,360,0.997222222,1,2,0.033333333,0.6,247
sub-2228_ses-T2,713,729,0.978052126,16,32,0.533333333,0.6,248
sub-2229_ses-T1,359,360,0.997222222,1,2,0.033333333,0.6,249
sub-2229_ses-T2,377,390,0.966666667,13,26,0.433333333,0.6,250
sub-2230_ses-T1,393,398,0.987437186,5,10,0.166666667,0.6,251
sub-7001_ses-f2,589,720,0.818055556,131,262,4.366666667,0.6,252
sub-7001_ses-f3,290,720,0.402777778,430,860,14.33333333,0.6,253
sub-7002_ses-f1,699,720,0.970833333,21,42,0.7,0.6,254
sub-7002_ses-f2,677,720,0.940277778,43,86,1.433333333,0.6,255
sub-7003_ses-f1,355,360,0.986111111,5,10,0.166666667,0.6,256
sub-7003_ses-f2,115,180,0.638888889,65,130,2.166666667,0.6,257
sub-7004_ses-f3,658,724,0.908839779,66,132,2.2,0.6,258
sub-7006_ses-f1,48,52,0.923076923,4,8,0.133333333,0.6,259
sub-7008_ses-f1,705,720,0.979166667,15,30,0.5,0.6,260
sub-7008_ses-f2,466,720,0.647222222,254,508,8.466666667,0.6,261
sub-7009_ses-f1,696,720,0.966666667,24,48,0.8,0.6,262
sub-7009_ses-f2,568,720,0.788888889,152,304,5.066666667,0.6,263
sub-7011_ses-f1,913,917,0.99563795,4,8,0.133333333,0.6,264
sub-7011_ses-f2,352,360,0.977777778,8,16,0.266666667,0.6,265
sub-7012_ses-f1,756,761,0.993429698,5,10,0.166666667,0.6,266
sub-7012_ses-f2,705,720,0.979166667,15,30,0.5,0.6,267
sub-7014_ses-f1,350,360,0.972222222,10,20,0.333333333,0.6,268
sub-7014_ses-f2,715,720,0.993055556,5,10,0.166666667,0.6,269
sub-7015_ses-f1,798,832,0.959134615,34,68,1.133333333,0.6,270
sub-7015_ses-f2,705,729,0.967078189,24,48,0.8,0.6,271
sub-7016_ses-f1,739,750,0.985333333,11,22,0.366666667,0.6,272
sub-7016_ses-f2,465,720,0.645833333,255,510,8.5,0.6,273
sub-7017_ses-f1,736,740,0.994594595,4,8,0.133333333,0.6,274
sub-7017_ses-f2,720,725,0.993103448,5,10,0.166666667,0.6,275
sub-7020_ses-f1,722,740,0.975675676,18,36,0.6,0.6,276
sub-7020_ses-f2,626,720,0.869444444,94,188,3.133333333,0.6,277
sub-7021_ses-f1,749,753,0.994687915,4,8,0.133333333,0.6,278
sub-7022_ses-f1,717,720,0.995833333,3,6,0.1,0.6,279
sub-7022_ses-f2,723,727,0.994497937,4,8,0.133333333,0.6,280
sub-7023_ses-f1,732,744,0.983870968,12,24,0.4,0.6,281
sub-7023_ses-f2,813,829,0.980699638,16,32,0.533333333,0.6,282
sub-7024_ses-f1,723,728,0.993131868,5,10,0.166666667,0.6,283
sub-7025_ses-f1,718,729,0.984910837,11,22,0.366666667,0.6,284
sub-7025_ses-f2,672,760,0.884210526,88,176,2.933333333,0.6,285
sub-7026_ses-f1,900,920,0.97826087,20,40,0.666666667,0.6,286
sub-7026_ses-f2,907,914,0.992341357,7,14,0.233333333,0.6,287
sub-7026_ses-f3,571,731,0.781121751,160,320,5.333333333,0.6,288
sub-7027_ses-f1,880,885,0.994350282,5,10,0.166666667,0.6,289
sub-7027_ses-f2,385,410,0.93902439,25,50,0.833333333,0.6,290
sub-7027_ses-f3,675,725,0.931034483,50,100,1.666666667,0.6,291
sub-7028_ses-f1,749,752,0.996010638,3,6,0.1,0.6,292
sub-7028_ses-f2,718,720,0.997222222,2,4,0.066666667,0.6,293
sub-7029_ses-f1,715,731,0.978112175,16,32,0.533333333,0.6,294
sub-7029_ses-f2,685,725,0.944827586,40,80,1.333333333,0.6,295
sub-7030_ses-f1,649,720,0.901388889,71,142,2.366666667,0.6,296
sub-7030_ses-f2,730,794,0.919395466,64,128,2.133333333,0.6,297
sub-7031_ses-f1,113,192,0.588541667,79,158,2.633333333,0.6,298
sub-7031_ses-f2,264,374,0.705882353,110,220,3.666666667,0.6,299
sub-7031_ses-f3,723,737,0.981004071,14,28,0.466666667,0.6,300
sub-7032_ses-f1,718,720,0.997222222,2,4,0.066666667,0.6,301
sub-7032_ses-f2,69,73,0.945205479,4,8,0.133333333,0.6,302
sub-7032_ses-f3,731,740,0.987837838,9,18,0.3,0.6,303
sub-7033_ses-f2,611,752,0.8125,141,282,4.7,0.6,304
sub-7034_ses-f1,750,760,0.986842105,10,20,0.333333333,0.6,305
sub-7034_ses-f2,882,912,0.967105263,30,60,1,0.6,306
sub-7034_ses-f3,579,728,0.79532967,149,298,4.966666667,0.6,307
sub-7035_ses-f1,43,50,0.86,7,14,0.233333333,0.6,308
sub-7035_ses-f2,687,727,0.944979367,40,80,1.333333333,0.6,309
sub-7036_ses-f1,713,745,0.95704698,32,64,1.066666667,0.6,310
sub-7037_ses-f1,769,772,0.99611399,3,6,0.1,0.6,311
sub-7037_ses-f2,845,852,0.991784038,7,14,0.233333333,0.6,312
sub-7037_ses-f3,708,720,0.983333333,12,24,0.4,0.6,313
sub-7038_ses-f1,758,789,0.960709759,31,62,1.033333333,0.6,314
sub-7038_ses-f2,629,785,0.801273885,156,312,5.2,0.6,315
sub-7039_ses-f1,751,785,0.956687898,34,68,1.133333333,0.6,316
sub-7039_ses-f2,683,727,0.939477304,44,88,1.466666667,0.6,317
sub-7040_ses-f1,683,728,0.938186813,45,90,1.5,0.6,318
sub-7040_ses-f2,657,720,0.9125,63,126,2.1,0.6,319
sub-7040_ses-f3,624,720,0.866666667,96,192,3.2,0.6,320
sub-7041_ses-f1,748,754,0.99204244,6,12,0.2,0.6,321
sub-7041_ses-f2,674,735,0.917006803,61,122,2.033333333,0.6,322
sub-7042_ses-f3,608,658,0.924012158,50,100,1.666666667,0.6,323
sub-7043_ses-f2,1014,1080,0.938888889,66,132,2.2,0.6,324
sub-7044_ses-f2,718,739,0.971583221,21,42,0.7,0.6,325
sub-7045_ses-f1,801,823,0.97326853,22,44,0.733333333,0.6,326
sub-7046_ses-f1,804,812,0.990147783,8,16,0.266666667,0.6,327
sub-7046_ses-f2,43,61,0.704918033,18,36,0.6,0.6,328
sub-7046_ses-f3,706,741,0.952766532,35,70,1.166666667,0.6,329
sub-7047_ses-f1,718,720,0.997222222,2,4,0.066666667,0.6,330
sub-7047_ses-f2,45,64,0.703125,19,38,0.633333333,0.6,331
sub-7048_ses-f1,5,6,0.833333333,1,2,0.033333333,0.6,332
sub-7048_ses-f2,348,360,0.966666667,12,24,0.4,0.6,333
sub-7049_ses-f1,347,360,0.963888889,13,26,0.433333333,0.6,334
sub-7052_ses-f1,504,518,0.972972973,14,28,0.466666667,0.6,335
sub-7053_ses-f1,710,720,0.986111111,10,20,0.333333333,0.6,336
sub-7054_ses-f1,714,766,0.932114883,52,104,1.733333333,0.6,337
sub-2006_ses-T1,365,420,0.869047619,55,110,1.833333333,0.7,1
sub-2011_ses-T1,340,360,0.944444444,20,40,0.666666667,0.7,2
sub-2012_ses-T1,179,180,0.994444444,1,2,0.033333333,0.7,3
sub-2013_ses-T1,336,360,0.933333333,24,48,0.8,0.7,4
sub-2014_ses-T1,351,360,0.975,9,18,0.3,0.7,5
sub-2015_ses-T1,109,180,0.605555556,71,142,2.366666667,0.7,6
sub-2016_ses-T1,354,360,0.983333333,6,12,0.2,0.7,7
sub-2017_ses-T1,179,180,0.994444444,1,2,0.033333333,0.7,8
sub-2018_ses-T1,170,180,0.944444444,10,20,0.333333333,0.7,9
sub-2019_ses-T1,355,360,0.986111111,5,10,0.166666667,0.7,10
sub-2020_ses-T1,19,26,0.730769231,7,14,0.233333333,0.7,11
sub-2020_ses-T2,337,360,0.936111111,23,46,0.766666667,0.7,12
sub-2021_ses-T1,345,360,0.958333333,15,30,0.5,0.7,13
sub-2022_ses-T1,334,360,0.927777778,26,52,0.866666667,0.7,14
sub-2023_ses-T1,225,360,0.625,135,270,4.5,0.7,15
sub-2024_ses-T2,11,12,0.916666667,1,2,0.033333333,0.7,16
sub-2026_ses-T1,218,223,0.977578475,5,10,0.166666667,0.7,17
sub-2027_ses-T1,358,360,0.994444444,2,4,0.066666667,0.7,18
sub-2028_ses-T1,321,360,0.891666667,39,78,1.3,0.7,19
sub-2029_ses-T1,350,360,0.972222222,10,20,0.333333333,0.7,20
sub-2030_ses-T1,309,360,0.858333333,51,102,1.7,0.7,21
sub-2031_ses-T1,358,360,0.994444444,2,4,0.066666667,0.7,22
sub-2032_ses-T1,302,360,0.838888889,58,116,1.933333333,0.7,23
sub-2033_ses-T1,357,360,0.991666667,3,6,0.1,0.7,24
sub-2033_ses-T2,251,360,0.697222222,109,218,3.633333333,0.7,25
sub-2034_ses-T1,134,180,0.744444444,46,92,1.533333333,0.7,26
sub-2035_ses-T1,358,360,0.994444444,2,4,0.066666667,0.7,27
sub-2036_ses-T1,357,360,0.991666667,3,6,0.1,0.7,28
sub-2037_ses-T1,353,360,0.980555556,7,14,0.233333333,0.7,29
sub-2038_ses-T1,358,360,0.994444444,2,4,0.066666667,0.7,30
sub-2039_ses-T1,179,180,0.994444444,1,2,0.033333333,0.7,31
sub-2040_ses-T1,356,360,0.988888889,4,8,0.133333333,0.7,32
sub-2041_ses-T1,358,360,0.994444444,2,4,0.066666667,0.7,33
sub-2042_ses-T1,174,180,0.966666667,6,12,0.2,0.7,34
sub-2043_ses-T1,265,360,0.736111111,95,190,3.166666667,0.7,35
sub-2044_ses-T1,316,360,0.877777778,44,88,1.466666667,0.7,36
sub-2045_ses-T1,152,180,0.844444444,28,56,0.933333333,0.7,37
sub-2046_ses-T1,175,180,0.972222222,5,10,0.166666667,0.7,38
sub-2047_ses-T1,170,180,0.944444444,10,20,0.333333333,0.7,39
sub-2048_ses-T1,176,180,0.977777778,4,8,0.133333333,0.7,40
sub-2049_ses-T1,352,360,0.977777778,8,16,0.266666667,0.7,41
sub-2051_ses-T1,357,360,0.991666667,3,6,0.1,0.7,42
sub-2051_ses-T2,358,360,0.994444444,2,4,0.066666667,0.7,43
sub-2052_ses-T1,337,360,0.936111111,23,46,0.766666667,0.7,44
sub-2052_ses-T2,142,180,0.788888889,38,76,1.266666667,0.7,45
sub-2053_ses-T1,304,360,0.844444444,56,112,1.866666667,0.7,46
sub-2055_ses-T1,134,180,0.744444444,46,92,1.533333333,0.7,47
sub-2056_ses-T1,358,360,0.994444444,2,4,0.066666667,0.7,48
sub-2057_ses-T1,358,360,0.994444444,2,4,0.066666667,0.7,49
sub-2058_ses-T1,291,360,0.808333333,69,138,2.3,0.7,50
sub-2059_ses-T1,280,360,0.777777778,80,160,2.666666667,0.7,51
sub-2061_ses-T1,148,180,0.822222222,32,64,1.066666667,0.7,52
sub-2062_ses-T1,356,360,0.988888889,4,8,0.133333333,0.7,53
sub-2063_ses-T1,345,360,0.958333333,15,30,0.5,0.7,54
sub-2064_ses-T1,175,180,0.972222222,5,10,0.166666667,0.7,55
sub-2065_ses-T1,151,180,0.838888889,29,58,0.966666667,0.7,56
sub-2066_ses-T1,176,180,0.977777778,4,8,0.133333333,0.7,57
sub-2066_ses-T2,353,360,0.980555556,7,14,0.233333333,0.7,58
sub-2067_ses-T1,356,360,0.988888889,4,8,0.133333333,0.7,59
sub-2068_ses-T1,355,360,0.986111111,5,10,0.166666667,0.7,60
sub-2069_ses-T1,347,360,0.963888889,13,26,0.433333333,0.7,61
sub-2070_ses-T1,344,360,0.955555556,16,32,0.533333333,0.7,62
sub-2071_ses-T1,350,360,0.972222222,10,20,0.333333333,0.7,63
sub-2072_ses-T1,357,360,0.991666667,3,6,0.1,0.7,64
sub-2073_ses-T1,254,256,0.9921875,2,4,0.066666667,0.7,65
sub-2073_ses-T2,164,180,0.911111111,16,32,0.533333333,0.7,66
sub-2074_ses-T1,159,180,0.883333333,21,42,0.7,0.7,67
sub-2075_ses-T1,179,180,0.994444444,1,2,0.033333333,0.7,68
sub-2076_ses-T1,329,360,0.913888889,31,62,1.033333333,0.7,69
sub-2076_ses-T2,282,360,0.783333333,78,156,2.6,0.7,70
sub-2077_ses-T1,358,360,0.994444444,2,4,0.066666667,0.7,71
sub-2078_ses-T1,357,360,0.991666667,3,6,0.1,0.7,72
sub-2079_ses-T1,354,360,0.983333333,6,12,0.2,0.7,73
sub-2079_ses-T2,293,360,0.813888889,67,134,2.233333333,0.7,74
sub-2080_ses-T1,281,360,0.780555556,79,158,2.633333333,0.7,75
sub-2081_ses-T1,357,360,0.991666667,3,6,0.1,0.7,76
sub-2082_ses-T1,335,360,0.930555556,25,50,0.833333333,0.7,77
sub-2083_ses-T1,283,360,0.786111111,77,154,2.566666667,0.7,78
sub-2084_ses-T1,358,360,0.994444444,2,4,0.066666667,0.7,79
sub-2085_ses-T1,347,360,0.963888889,13,26,0.433333333,0.7,80
sub-2086_ses-T1,243,360,0.675,117,234,3.9,0.7,81
sub-2087_ses-T1,355,360,0.986111111,5,10,0.166666667,0.7,82
sub-2088_ses-T1,353,360,0.980555556,7,14,0.233333333,0.7,83
sub-2089_ses-T1,179,180,0.994444444,1,2,0.033333333,0.7,84
sub-2091_ses-T1,310,360,0.861111111,50,100,1.666666667,0.7,85
sub-2092_ses-T1,348,360,0.966666667,12,24,0.4,0.7,86
sub-2093_ses-T1,353,360,0.980555556,7,14,0.233333333,0.7,87
sub-2094_ses-T1,173,180,0.961111111,7,14,0.233333333,0.7,88
sub-2095_ses-T1,357,360,0.991666667,3,6,0.1,0.7,89
sub-2096_ses-T1,344,360,0.955555556,16,32,0.533333333,0.7,90
sub-2097_ses-T1,534,540,0.988888889,6,12,0.2,0.7,91
sub-2098_ses-T1,296,360,0.822222222,64,128,2.133333333,0.7,92
sub-2099_ses-T1,178,180,0.988888889,2,4,0.066666667,0.7,93
sub-2099_ses-T2,353,360,0.980555556,7,14,0.233333333,0.7,94
sub-2100_ses-T1,171,180,0.95,9,18,0.3,0.7,95
sub-2100_ses-T2,335,360,0.930555556,25,50,0.833333333,0.7,96
sub-2101_ses-T1,342,360,0.95,18,36,0.6,0.7,97
sub-2101_ses-T2,321,360,0.891666667,39,78,1.3,0.7,98
sub-2102_ses-T1,358,360,0.994444444,2,4,0.066666667,0.7,99
sub-2103_ses-T1,344,360,0.955555556,16,32,0.533333333,0.7,100
sub-2103_ses-T2,358,360,0.994444444,2,4,0.066666667,0.7,101
sub-2104_ses-T1,382,387,0.987080103,5,10,0.166666667,0.7,102
sub-2105_ses-T1,357,360,0.991666667,3,6,0.1,0.7,103
sub-2105_ses-T2,357,360,0.991666667,3,6,0.1,0.7,104
sub-2106_ses-T1,358,360,0.994444444,2,4,0.066666667,0.7,105
sub-2107_ses-T1,307,360,0.852777778,53,106,1.766666667,0.7,106
sub-2107_ses-T2,310,360,0.861111111,50,100,1.666666667,0.7,107
sub-2108_ses-T1,358,360,0.994444444,2,4,0.066666667,0.7,108
sub-2108_ses-T3,138,141,0.978723404,3,6,0.1,0.7,109
sub-2109_ses-T1,177,180,0.983333333,3,6,0.1,0.7,110
sub-2110_ses-T1,270,274,0.98540146,4,8,0.133333333,0.7,111
sub-2115_ses-T1,358,360,0.994444444,2,4,0.066666667,0.7,112
sub-2115_ses-T2,354,360,0.983333333,6,12,0.2,0.7,113
sub-2117_ses-T1,354,360,0.983333333,6,12,0.2,0.7,114
sub-2117_ses-T2,320,360,0.888888889,40,80,1.333333333,0.7,115
sub-2118_ses-T1,337,360,0.936111111,23,46,0.766666667,0.7,116
sub-2120_ses-T1,355,360,0.986111111,5,10,0.166666667,0.7,117
sub-2122_ses-T1,349,360,0.969444444,11,22,0.366666667,0.7,118
sub-2123_ses-T1,357,360,0.991666667,3,6,0.1,0.7,119
sub-2124_ses-T1,349,404,0.863861386,55,110,1.833333333,0.7,120
sub-2126_ses-T1,354,360,0.983333333,6,12,0.2,0.7,121
sub-2128_ses-T1,357,360,0.991666667,3,6,0.1,0.7,122
sub-2133_ses-T1,347,360,0.963888889,13,26,0.433333333,0.7,123
sub-2135_ses-T1,8,19,0.421052632,11,22,0.366666667,0.7,124
sub-2136_ses-T1,659,720,0.915277778,61,122,2.033333333,0.7,125
sub-2137_ses-T1,693,720,0.9625,27,54,0.9,0.7,126
sub-2137_ses-T2,223,360,0.619444444,137,274,4.566666667,0.7,127
sub-2138_ses-T1,359,360,0.997222222,1,2,0.033333333,0.7,128
sub-2139_ses-T1,304,360,0.844444444,56,112,1.866666667,0.7,129
sub-2140_ses-T1,377,379,0.994722955,2,4,0.066666667,0.7,130
sub-2141_ses-T1,323,360,0.897222222,37,74,1.233333333,0.7,131
sub-2142_ses-T2,359,360,0.997222222,1,2,0.033333333,0.7,132
sub-2143_ses-T1,340,360,0.944444444,20,40,0.666666667,0.7,133
sub-2144_ses-T1,349,372,0.938172043,23,46,0.766666667,0.7,134
sub-2145_ses-T1,339,360,0.941666667,21,42,0.7,0.7,135
sub-2145_ses-T2,304,360,0.844444444,56,112,1.866666667,0.7,136
sub-2146_ses-T1,357,360,0.991666667,3,6,0.1,0.7,137
sub-2146_ses-T2,678,720,0.941666667,42,84,1.4,0.7,138
sub-2147_ses-T1,348,360,0.966666667,12,24,0.4,0.7,139
sub-2147_ses-T2,353,360,0.980555556,7,14,0.233333333,0.7,140
sub-2148_ses-T1,396,399,0.992481203,3,6,0.1,0.7,141
sub-2149_ses-T1,351,360,0.975,9,18,0.3,0.7,142
sub-2150_ses-T1,359,360,0.997222222,1,2,0.033333333,0.7,143
sub-2150_ses-T2,351,360,0.975,9,18,0.3,0.7,144
sub-2151_ses-T1,700,720,0.972222222,20,40,0.666666667,0.7,145
sub-2151_ses-T2,745,773,0.96377749,28,56,0.933333333,0.7,146
sub-2152_ses-T1,359,360,0.997222222,1,2,0.033333333,0.7,147
sub-2152_ses-T2,351,360,0.975,9,18,0.3,0.7,148
sub-2153_ses-T1,379,383,0.989556136,4,8,0.133333333,0.7,149
sub-2154_ses-T2,359,360,0.997222222,1,2,0.033333333,0.7,150
sub-2155_ses-T1,357,360,0.991666667,3,6,0.1,0.7,151
sub-2156_ses-T1,328,360,0.911111111,32,64,1.066666667,0.7,152
sub-2157_ses-T1,356,360,0.988888889,4,8,0.133333333,0.7,153
sub-2158_ses-T1,349,360,0.969444444,11,22,0.366666667,0.7,154
sub-2159_ses-T1,339,360,0.941666667,21,42,0.7,0.7,155
sub-2160_ses-T1,340,360,0.944444444,20,40,0.666666667,0.7,156
sub-2161_ses-T1,352,360,0.977777778,8,16,0.266666667,0.7,157
sub-2162_ses-T1,357,360,0.991666667,3,6,0.1,0.7,158
sub-2163_ses-T1,391,399,0.979949875,8,16,0.266666667,0.7,159
sub-2164_ses-T1,530,720,0.736111111,190,380,6.333333333,0.7,160
sub-2164_ses-T2,640,720,0.888888889,80,160,2.666666667,0.7,161
sub-2165_ses-T1,448,481,0.931392931,33,66,1.1,0.7,162
sub-2166_ses-T1,357,360,0.991666667,3,6,0.1,0.7,163
sub-2166_ses-T2,314,360,0.872222222,46,92,1.533333333,0.7,164
sub-2167_ses-T1,364,370,0.983783784,6,12,0.2,0.7,165
sub-2168_ses-T1,358,360,0.994444444,2,4,0.066666667,0.7,166
sub-2168_ses-T2,347,360,0.963888889,13,26,0.433333333,0.7,167
sub-2169_ses-T1,357,360,0.991666667,3,6,0.1,0.7,168
sub-2169_ses-T2,341,360,0.947222222,19,38,0.633333333,0.7,169
sub-2170_ses-T1,240,264,0.909090909,24,48,0.8,0.7,170
sub-2171_ses-T1,367,374,0.981283422,7,14,0.233333333,0.7,171
sub-2171_ses-T2,405,483,0.838509317,78,156,2.6,0.7,172
sub-2171_ses-T3,488,577,0.845753899,89,178,2.966666667,0.7,173
sub-2172_ses-T1,475,513,0.925925926,38,76,1.266666667,0.7,174
sub-2172_ses-T2,380,386,0.984455959,6,12,0.2,0.7,175
sub-2173_ses-T1,323,360,0.897222222,37,74,1.233333333,0.7,176
sub-2174_ses-T1,399,416,0.959134615,17,34,0.566666667,0.7,177
sub-2175_ses-T1,672,679,0.989690722,7,14,0.233333333,0.7,178
sub-2176_ses-T1,277,360,0.769444444,83,166,2.766666667,0.7,179
sub-2176_ses-T2,138,360,0.383333333,222,444,7.4,0.7,180
sub-2177_ses-T1,688,695,0.989928058,7,14,0.233333333,0.7,181
sub-2177_ses-T2,733,736,0.995923913,3,6,0.1,0.7,182
sub-2178_ses-T2,344,360,0.955555556,16,32,0.533333333,0.7,183
sub-2179_ses-T2,702,720,0.975,18,36,0.6,0.7,184
sub-2180_ses-T1,323,360,0.897222222,37,74,1.233333333,0.7,185
sub-2180_ses-T2,199,360,0.552777778,161,322,5.366666667,0.7,186
sub-2181_ses-T1,357,360,0.991666667,3,6,0.1,0.7,187
sub-2182_ses-T1,49,51,0.960784314,2,4,0.066666667,0.7,188
sub-2184_ses-T1,384,391,0.982097187,7,14,0.233333333,0.7,189
sub-2185_ses-T1,356,360,0.988888889,4,8,0.133333333,0.7,190
sub-2186_ses-T1,345,371,0.929919137,26,52,0.866666667,0.7,191
sub-2187_ses-T1,46,48,0.958333333,2,4,0.066666667,0.7,192
sub-2188_ses-T1,438,445,0.984269663,7,14,0.233333333,0.7,193
sub-2189_ses-T1,200,204,0.980392157,4,8,0.133333333,0.7,194
sub-2190_ses-T1,345,360,0.958333333,15,30,0.5,0.7,195
sub-2191_ses-T1,359,360,0.997222222,1,2,0.033333333,0.7,196
sub-2191_ses-T2,312,360,0.866666667,48,96,1.6,0.7,197
sub-2192_ses-T1,359,360,0.997222222,1,2,0.033333333,0.7,198
sub-2193_ses-T2,616,625,0.9856,9,18,0.3,0.7,199
sub-2194_ses-T1,408,415,0.98313253,7,14,0.233333333,0.7,200
sub-2195_ses-T1,196,360,0.544444444,164,328,5.466666667,0.7,201
sub-2196_ses-T1,369,416,0.887019231,47,94,1.566666667,0.7,202
sub-2197_ses-T1,428,439,0.974943052,11,22,0.366666667,0.7,203
sub-2197_ses-T2,353,384,0.919270833,31,62,1.033333333,0.7,204
sub-2198_ses-T1,401,407,0.985257985,6,12,0.2,0.7,205
sub-2199_ses-T1,399,404,0.987623762,5,10,0.166666667,0.7,206
sub-2200_ses-T1,348,360,0.966666667,12,24,0.4,0.7,207
sub-2201_ses-T1,359,360,0.997222222,1,2,0.033333333,0.7,208
sub-2202_ses-T1,568,606,0.937293729,38,76,1.266666667,0.7,209
sub-2203_ses-T1,344,360,0.955555556,16,32,0.533333333,0.7,210
sub-2204_ses-T1,347,360,0.963888889,13,26,0.433333333,0.7,211
sub-2204_ses-T2,358,360,0.994444444,2,4,0.066666667,0.7,212
sub-2205_ses-T1,355,360,0.986111111,5,10,0.166666667,0.7,213
sub-2206_ses-T1,358,360,0.994444444,2,4,0.066666667,0.7,214
sub-2206_ses-T2,674,720,0.936111111,46,92,1.533333333,0.7,215
sub-2207_ses-T1,312,360,0.866666667,48,96,1.6,0.7,216
sub-2207_ses-T2,333,360,0.925,27,54,0.9,0.7,217
sub-2208_ses-T1,347,360,0.963888889,13,26,0.433333333,0.7,218
sub-2208_ses-T2,335,360,0.930555556,25,50,0.833333333,0.7,219
sub-2209_ses-T1,337,341,0.988269795,4,8,0.133333333,0.7,220
sub-2210_ses-T1,34,38,0.894736842,4,8,0.133333333,0.7,221
sub-2211_ses-T1,359,360,0.997222222,1,2,0.033333333,0.7,222
sub-2212_ses-T1,359,360,0.997222222,1,2,0.033333333,0.7,223
sub-2213_ses-T1,270,286,0.944055944,16,32,0.533333333,0.7,224
sub-2214_ses-T1,371,373,0.99463807,2,4,0.066666667,0.7,225
sub-2215_ses-T1,359,360,0.997222222,1,2,0.033333333,0.7,226
sub-2216_ses-T1,73,86,0.848837209,13,26,0.433333333,0.7,227
sub-2216_ses-T2,145,181,0.801104972,36,72,1.2,0.7,228
sub-2217_ses-T1,304,360,0.844444444,56,112,1.866666667,0.7,229
sub-2217_ses-T2,133,360,0.369444444,227,454,7.566666667,0.7,230
sub-2218_ses-T1,354,360,0.983333333,6,12,0.2,0.7,231
sub-2218_ses-T2,604,720,0.838888889,116,232,3.866666667,0.7,232
sub-2219_ses-T1,359,360,0.997222222,1,2,0.033333333,0.7,233
sub-2220_ses-T1,358,360,0.994444444,2,4,0.066666667,0.7,234
sub-2220_ses-T2,686,720,0.952777778,34,68,1.133333333,0.7,235
sub-2221_ses-T1,328,360,0.911111111,32,64,1.066666667,0.7,236
sub-2221_ses-T2,678,720,0.941666667,42,84,1.4,0.7,237
sub-2222_ses-T1,342,360,0.95,18,36,0.6,0.7,238
sub-2223_ses-T1,356,360,0.988888889,4,8,0.133333333,0.7,239
sub-2223_ses-T2,660,720,0.916666667,60,120,2,0.7,240
sub-2224_ses-T1,348,379,0.918205805,31,62,1.033333333,0.7,241
sub-2225_ses-T1,357,360,0.991666667,3,6,0.1,0.7,242
sub-2225_ses-T2,733,759,0.965744401,26,52,0.866666667,0.7,243
sub-2226_ses-T1,319,365,0.873972603,46,92,1.533333333,0.7,244
sub-2226_ses-T2,321,360,0.891666667,39,78,1.3,0.7,245
sub-2227_ses-T1,356,360,0.988888889,4,8,0.133333333,0.7,246
sub-2228_ses-T1,359,360,0.997222222,1,2,0.033333333,0.7,247
sub-2228_ses-T2,705,729,0.967078189,24,48,0.8,0.7,248
sub-2229_ses-T1,359,360,0.997222222,1,2,0.033333333,0.7,249
sub-2229_ses-T2,374,390,0.958974359,16,32,0.533333333,0.7,250
sub-2230_ses-T1,391,398,0.98241206,7,14,0.233333333,0.7,251
sub-7001_ses-f2,544,720,0.755555556,176,352,5.866666667,0.7,252
sub-7001_ses-f3,259,720,0.359722222,461,922,15.36666667,0.7,253
sub-7002_ses-f1,683,720,0.948611111,37,74,1.233333333,0.7,254
sub-7002_ses-f2,653,720,0.906944444,67,134,2.233333333,0.7,255
sub-7003_ses-f1,350,360,0.972222222,10,20,0.333333333,0.7,256
sub-7003_ses-f2,95,180,0.527777778,85,170,2.833333333,0.7,257
sub-7004_ses-f3,625,724,0.863259669,99,198,3.3,0.7,258
sub-7006_ses-f1,48,52,0.923076923,4,8,0.133333333,0.7,259
sub-7008_ses-f1,701,720,0.973611111,19,38,0.633333333,0.7,260
sub-7008_ses-f2,397,720,0.551388889,323,646,10.76666667,0.7,261
sub-7009_ses-f1,681,720,0.945833333,39,78,1.3,0.7,262
sub-7009_ses-f2,520,720,0.722222222,200,400,6.666666667,0.7,263
sub-7011_ses-f1,912,917,0.994547437,5,10,0.166666667,0.7,264
sub-7011_ses-f2,349,360,0.969444444,11,22,0.366666667,0.7,265
sub-7012_ses-f1,755,761,0.992115637,6,12,0.2,0.7,266
sub-7012_ses-f2,695,720,0.965277778,25,50,0.833333333,0.7,267
sub-7014_ses-f1,348,360,0.966666667,12,24,0.4,0.7,268
sub-7014_ses-f2,712,720,0.988888889,8,16,0.266666667,0.7,269
sub-7015_ses-f1,792,832,0.951923077,40,80,1.333333333,0.7,270
sub-7015_ses-f2,693,729,0.950617284,36,72,1.2,0.7,271
sub-7016_ses-f1,726,750,0.968,24,48,0.8,0.7,272
sub-7016_ses-f2,402,720,0.558333333,318,636,10.6,0.7,273
sub-7017_ses-f1,736,740,0.994594595,4,8,0.133333333,0.7,274
sub-7017_ses-f2,716,725,0.987586207,9,18,0.3,0.7,275
sub-7020_ses-f1,718,740,0.97027027,22,44,0.733333333,0.7,276
sub-7020_ses-f2,584,720,0.811111111,136,272,4.533333333,0.7,277
sub-7021_ses-f1,749,753,0.994687915,4,8,0.133333333,0.7,278
sub-7022_ses-f1,716,720,0.994444444,4,8,0.133333333,0.7,279
sub-7022_ses-f2,723,727,0.994497937,4,8,0.133333333,0.7,280
sub-7023_ses-f1,729,744,0.97983871,15,30,0.5,0.7,281
sub-7023_ses-f2,805,829,0.971049457,24,48,0.8,0.7,282
sub-7024_ses-f1,721,728,0.990384615,7,14,0.233333333,0.7,283
sub-7025_ses-f1,714,729,0.979423868,15,30,0.5,0.7,284
sub-7025_ses-f2,630,760,0.828947368,130,260,4.333333333,0.7,285
sub-7026_ses-f1,894,920,0.97173913,26,52,0.866666667,0.7,286
sub-7026_ses-f2,901,914,0.985776805,13,26,0.433333333,0.7,287
sub-7026_ses-f3,522,731,0.714090287,209,418,6.966666667,0.7,288
sub-7027_ses-f1,880,885,0.994350282,5,10,0.166666667,0.7,289
sub-7027_ses-f2,369,410,0.9,41,82,1.366666667,0.7,290
sub-7027_ses-f3,656,725,0.904827586,69,138,2.3,0.7,291
sub-7028_ses-f1,749,752,0.996010638,3,6,0.1,0.7,292
sub-7028_ses-f2,718,720,0.997222222,2,4,0.066666667,0.7,293
sub-7029_ses-f1,706,731,0.965800274,25,50,0.833333333,0.7,294
sub-7029_ses-f2,660,725,0.910344828,65,130,2.166666667,0.7,295
sub-7030_ses-f1,642,720,0.891666667,78,156,2.6,0.7,296
sub-7030_ses-f2,694,794,0.874055416,100,200,3.333333333,0.7,297
sub-7031_ses-f1,92,192,0.479166667,100,200,3.333333333,0.7,298
sub-7031_ses-f2,225,374,0.601604278,149,298,4.966666667,0.7,299
sub-7031_ses-f3,713,737,0.96743555,24,48,0.8,0.7,300
sub-7032_ses-f1,718,720,0.997222222,2,4,0.066666667,0.7,301
sub-7032_ses-f2,69,73,0.945205479,4,8,0.133333333,0.7,302
sub-7032_ses-f3,729,740,0.985135135,11,22,0.366666667,0.7,303
sub-7033_ses-f2,579,752,0.769946809,173,346,5.766666667,0.7,304
sub-7034_ses-f1,747,760,0.982894737,13,26,0.433333333,0.7,305
sub-7034_ses-f2,864,912,0.947368421,48,96,1.6,0.7,306
sub-7034_ses-f3,524,728,0.71978022,204,408,6.8,0.7,307
sub-7035_ses-f1,42,50,0.84,8,16,0.266666667,0.7,308
sub-7035_ses-f2,648,727,0.89133425,79,158,2.633333333,0.7,309
sub-7036_ses-f1,692,745,0.92885906,53,106,1.766666667,0.7,310
sub-7037_ses-f1,769,772,0.99611399,3,6,0.1,0.7,311
sub-7037_ses-f2,845,852,0.991784038,7,14,0.233333333,0.7,312
sub-7037_ses-f3,703,720,0.976388889,17,34,0.566666667,0.7,313
sub-7038_ses-f1,744,789,0.942965779,45,90,1.5,0.7,314
sub-7038_ses-f2,583,785,0.742675159,202,404,6.733333333,0.7,315
sub-7039_ses-f1,736,785,0.937579618,49,98,1.633333333,0.7,316
sub-7039_ses-f2,662,727,0.910591472,65,130,2.166666667,0.7,317
sub-7040_ses-f1,660,728,0.906593407,68,136,2.266666667,0.7,318
sub-7040_ses-f2,627,720,0.870833333,93,186,3.1,0.7,319
sub-7040_ses-f3,582,720,0.808333333,138,276,4.6,0.7,320
sub-7041_ses-f1,747,754,0.99071618,7,14,0.233333333,0.7,321
sub-7041_ses-f2,640,735,0.870748299,95,190,3.166666667,0.7,322
sub-7042_ses-f3,584,658,0.887537994,74,148,2.466666667,0.7,323
sub-7043_ses-f2,984,1080,0.911111111,96,192,3.2,0.7,324
sub-7044_ses-f2,705,739,0.953991881,34,68,1.133333333,0.7,325
sub-7045_ses-f1,796,823,0.967193196,27,54,0.9,0.7,326
sub-7046_ses-f1,793,812,0.976600985,19,38,0.633333333,0.7,327
sub-7046_ses-f2,40,61,0.655737705,21,42,0.7,0.7,328
sub-7046_ses-f3,691,741,0.932523617,50,100,1.666666667,0.7,329
sub-7047_ses-f1,718,720,0.997222222,2,4,0.066666667,0.7,330
sub-7047_ses-f2,42,64,0.65625,22,44,0.733333333,0.7,331
sub-7048_ses-f1,5,6,0.833333333,1,2,0.033333333,0.7,332
sub-7048_ses-f2,336,360,0.933333333,24,48,0.8,0.7,333
sub-7049_ses-f1,339,360,0.941666667,21,42,0.7,0.7,334
sub-7052_ses-f1,495,518,0.955598456,23,46,0.766666667,0.7,335
sub-7053_ses-f1,705,720,0.979166667,15,30,0.5,0.7,336
sub-7054_ses-f1,708,766,0.924281984,58,116,1.933333333,0.7,337
sub-2006_ses-T1,348,420,0.828571429,72,144,2.4,0.8,1
sub-2011_ses-T1,328,360,0.911111111,32,64,1.066666667,0.8,2
sub-2012_ses-T1,179,180,0.994444444,1,2,0.033333333,0.8,3
sub-2013_ses-T1,327,360,0.908333333,33,66,1.1,0.8,4
sub-2014_ses-T1,349,360,0.969444444,11,22,0.366666667,0.8,5
sub-2015_ses-T1,92,180,0.511111111,88,176,2.933333333,0.8,6
sub-2016_ses-T1,350,360,0.972222222,10,20,0.333333333,0.8,7
sub-2017_ses-T1,179,180,0.994444444,1,2,0.033333333,0.8,8
sub-2018_ses-T1,165,180,0.916666667,15,30,0.5,0.8,9
sub-2019_ses-T1,352,360,0.977777778,8,16,0.266666667,0.8,10
sub-2020_ses-T1,19,26,0.730769231,7,14,0.233333333,0.8,11
sub-2020_ses-T2,318,360,0.883333333,42,84,1.4,0.8,12
sub-2021_ses-T1,338,360,0.938888889,22,44,0.733333333,0.8,13
sub-2022_ses-T1,328,360,0.911111111,32,64,1.066666667,0.8,14
sub-2023_ses-T1,214,360,0.594444444,146,292,4.866666667,0.8,15
sub-2024_ses-T2,11,12,0.916666667,1,2,0.033333333,0.8,16
sub-2026_ses-T1,216,223,0.968609865,7,14,0.233333333,0.8,17
sub-2027_ses-T1,358,360,0.994444444,2,4,0.066666667,0.8,18
sub-2028_ses-T1,311,360,0.863888889,49,98,1.633333333,0.8,19
sub-2029_ses-T1,345,360,0.958333333,15,30,0.5,0.8,20
sub-2030_ses-T1,289,360,0.802777778,71,142,2.366666667,0.8,21
sub-2031_ses-T1,357,360,0.991666667,3,6,0.1,0.8,22
sub-2032_ses-T1,279,360,0.775,81,162,2.7,0.8,23
sub-2033_ses-T1,355,360,0.986111111,5,10,0.166666667,0.8,24
sub-2033_ses-T2,234,360,0.65,126,252,4.2,0.8,25
sub-2034_ses-T1,122,180,0.677777778,58,116,1.933333333,0.8,26
sub-2035_ses-T1,358,360,0.994444444,2,4,0.066666667,0.8,27
sub-2036_ses-T1,357,360,0.991666667,3,6,0.1,0.8,28
sub-2037_ses-T1,353,360,0.980555556,7,14,0.233333333,0.8,29
sub-2038_ses-T1,358,360,0.994444444,2,4,0.066666667,0.8,30
sub-2039_ses-T1,179,180,0.994444444,1,2,0.033333333,0.8,31
sub-2040_ses-T1,351,360,0.975,9,18,0.3,0.8,32
sub-2041_ses-T1,357,360,0.991666667,3,6,0.1,0.8,33
sub-2042_ses-T1,168,180,0.933333333,12,24,0.4,0.8,34
sub-2043_ses-T1,229,360,0.636111111,131,262,4.366666667,0.8,35
sub-2044_ses-T1,306,360,0.85,54,108,1.8,0.8,36
sub-2045_ses-T1,148,180,0.822222222,32,64,1.066666667,0.8,37
sub-2046_ses-T1,172,180,0.955555556,8,16,0.266666667,0.8,38
sub-2047_ses-T1,164,180,0.911111111,16,32,0.533333333,0.8,39
sub-2048_ses-T1,175,180,0.972222222,5,10,0.166666667,0.8,40
sub-2049_ses-T1,350,360,0.972222222,10,20,0.333333333,0.8,41
sub-2051_ses-T1,357,360,0.991666667,3,6,0.1,0.8,42
sub-2051_ses-T2,358,360,0.994444444,2,4,0.066666667,0.8,43
sub-2052_ses-T1,329,360,0.913888889,31,62,1.033333333,0.8,44
sub-2052_ses-T2,128,180,0.711111111,52,104,1.733333333,0.8,45
sub-2053_ses-T1,280,360,0.777777778,80,160,2.666666667,0.8,46
sub-2055_ses-T1,121,180,0.672222222,59,118,1.966666667,0.8,47
sub-2056_ses-T1,358,360,0.994444444,2,4,0.066666667,0.8,48
sub-2057_ses-T1,357,360,0.991666667,3,6,0.1,0.8,49
sub-2058_ses-T1,284,360,0.788888889,76,152,2.533333333,0.8,50
sub-2059_ses-T1,273,360,0.758333333,87,174,2.9,0.8,51
sub-2061_ses-T1,141,180,0.783333333,39,78,1.3,0.8,52
sub-2062_ses-T1,355,360,0.986111111,5,10,0.166666667,0.8,53
sub-2063_ses-T1,338,360,0.938888889,22,44,0.733333333,0.8,54
sub-2064_ses-T1,173,180,0.961111111,7,14,0.233333333,0.8,55
sub-2065_ses-T1,144,180,0.8,36,72,1.2,0.8,56
sub-2066_ses-T1,173,180,0.961111111,7,14,0.233333333,0.8,57
sub-2066_ses-T2,350,360,0.972222222,10,20,0.333333333,0.8,58
sub-2067_ses-T1,355,360,0.986111111,5,10,0.166666667,0.8,59
sub-2068_ses-T1,352,360,0.977777778,8,16,0.266666667,0.8,60
sub-2069_ses-T1,336,360,0.933333333,24,48,0.8,0.8,61
sub-2070_ses-T1,336,360,0.933333333,24,48,0.8,0.8,62
sub-2071_ses-T1,346,360,0.961111111,14,28,0.466666667,0.8,63
sub-2072_ses-T1,356,360,0.988888889,4,8,0.133333333,0.8,64
sub-2073_ses-T1,254,256,0.9921875,2,4,0.066666667,0.8,65
sub-2073_ses-T2,161,180,0.894444444,19,38,0.633333333,0.8,66
sub-2074_ses-T1,146,180,0.811111111,34,68,1.133333333,0.8,67
sub-2075_ses-T1,178,180,0.988888889,2,4,0.066666667,0.8,68
sub-2076_ses-T1,306,360,0.85,54,108,1.8,0.8,69
sub-2076_ses-T2,235,360,0.652777778,125,250,4.166666667,0.8,70
sub-2077_ses-T1,358,360,0.994444444,2,4,0.066666667,0.8,71
sub-2078_ses-T1,357,360,0.991666667,3,6,0.1,0.8,72
sub-2079_ses-T1,352,360,0.977777778,8,16,0.266666667,0.8,73
sub-2079_ses-T2,271,360,0.752777778,89,178,2.966666667,0.8,74
sub-2080_ses-T1,262,360,0.727777778,98,196,3.266666667,0.8,75
sub-2081_ses-T1,357,360,0.991666667,3,6,0.1,0.8,76
sub-2082_ses-T1,330,360,0.916666667,30,60,1,0.8,77
sub-2083_ses-T1,255,360,0.708333333,105,210,3.5,0.8,78
sub-2084_ses-T1,358,360,0.994444444,2,4,0.066666667,0.8,79
sub-2085_ses-T1,339,360,0.941666667,21,42,0.7,0.8,80
sub-2086_ses-T1,222,360,0.616666667,138,276,4.6,0.8,81
sub-2087_ses-T1,355,360,0.986111111,5,10,0.166666667,0.8,82
sub-2088_ses-T1,350,360,0.972222222,10,20,0.333333333,0.8,83
sub-2089_ses-T1,179,180,0.994444444,1,2,0.033333333,0.8,84
sub-2091_ses-T1,292,360,0.811111111,68,136,2.266666667,0.8,85
sub-2092_ses-T1,339,360,0.941666667,21,42,0.7,0.8,86
sub-2093_ses-T1,348,360,0.966666667,12,24,0.4,0.8,87
sub-2094_ses-T1,173,180,0.961111111,7,14,0.233333333,0.8,88
sub-2095_ses-T1,357,360,0.991666667,3,6,0.1,0.8,89
sub-2096_ses-T1,342,360,0.95,18,36,0.6,0.8,90
sub-2097_ses-T1,531,540,0.983333333,9,18,0.3,0.8,91
sub-2098_ses-T1,289,360,0.802777778,71,142,2.366666667,0.8,92
sub-2099_ses-T1,177,180,0.983333333,3,6,0.1,0.8,93
sub-2099_ses-T2,353,360,0.980555556,7,14,0.233333333,0.8,94
sub-2100_ses-T1,168,180,0.933333333,12,24,0.4,0.8,95
sub-2100_ses-T2,324,360,0.9,36,72,1.2,0.8,96
sub-2101_ses-T1,337,360,0.936111111,23,46,0.766666667,0.8,97
sub-2101_ses-T2,309,360,0.858333333,51,102,1.7,0.8,98
sub-2102_ses-T1,356,360,0.988888889,4,8,0.133333333,0.8,99
sub-2103_ses-T1,339,360,0.941666667,21,42,0.7,0.8,100
sub-2103_ses-T2,358,360,0.994444444,2,4,0.066666667,0.8,101
sub-2104_ses-T1,380,387,0.981912145,7,14,0.233333333,0.8,102
sub-2105_ses-T1,357,360,0.991666667,3,6,0.1,0.8,103
sub-2105_ses-T2,357,360,0.991666667,3,6,0.1,0.8,104
sub-2106_ses-T1,358,360,0.994444444,2,4,0.066666667,0.8,105
sub-2107_ses-T1,285,360,0.791666667,75,150,2.5,0.8,106
sub-2107_ses-T2,301,360,0.836111111,59,118,1.966666667,0.8,107
sub-2108_ses-T1,358,360,0.994444444,2,4,0.066666667,0.8,108
sub-2108_ses-T3,138,141,0.978723404,3,6,0.1,0.8,109
sub-2109_ses-T1,175,180,0.972222222,5,10,0.166666667,0.8,110
sub-2110_ses-T1,269,274,0.981751825,5,10,0.166666667,0.8,111
sub-2115_ses-T1,357,360,0.991666667,3,6,0.1,0.8,112
sub-2115_ses-T2,350,360,0.972222222,10,20,0.333333333,0.8,113
sub-2117_ses-T1,354,360,0.983333333,6,12,0.2,0.8,114
sub-2117_ses-T2,305,360,0.847222222,55,110,1.833333333,0.8,115
sub-2118_ses-T1,320,360,0.888888889,40,80,1.333333333,0.8,116
sub-2120_ses-T1,353,360,0.980555556,7,14,0.233333333,0.8,117
sub-2122_ses-T1,346,360,0.961111111,14,28,0.466666667,0.8,118
sub-2123_ses-T1,354,360,0.983333333,6,12,0.2,0.8,119
sub-2124_ses-T1,347,404,0.858910891,57,114,1.9,0.8,120
sub-2126_ses-T1,349,360,0.969444444,11,22,0.366666667,0.8,121
sub-2128_ses-T1,351,360,0.975,9,18,0.3,0.8,122
sub-2133_ses-T1,342,360,0.95,18,36,0.6,0.8,123
sub-2135_ses-T1,8,19,0.421052632,11,22,0.366666667,0.8,124
sub-2136_ses-T1,642,720,0.891666667,78,156,2.6,0.8,125
sub-2137_ses-T1,677,720,0.940277778,43,86,1.433333333,0.8,126
sub-2137_ses-T2,198,360,0.55,162,324,5.4,0.8,127
sub-2138_ses-T1,359,360,0.997222222,1,2,0.033333333,0.8,128
sub-2139_ses-T1,276,360,0.766666667,84,168,2.8,0.8,129
sub-2140_ses-T1,377,379,0.994722955,2,4,0.066666667,0.8,130
sub-2141_ses-T1,310,360,0.861111111,50,100,1.666666667,0.8,131
sub-2142_ses-T2,358,360,0.994444444,2,4,0.066666667,0.8,132
sub-2143_ses-T1,331,360,0.919444444,29,58,0.966666667,0.8,133
sub-2144_ses-T1,341,372,0.916666667,31,62,1.033333333,0.8,134
sub-2145_ses-T1,330,360,0.916666667,30,60,1,0.8,135
sub-2145_ses-T2,273,360,0.758333333,87,174,2.9,0.8,136
sub-2146_ses-T1,356,360,0.988888889,4,8,0.133333333,0.8,137
sub-2146_ses-T2,656,720,0.911111111,64,128,2.133333333,0.8,138
sub-2147_ses-T1,341,360,0.947222222,19,38,0.633333333,0.8,139
sub-2147_ses-T2,349,360,0.969444444,11,22,0.366666667,0.8,140
sub-2148_ses-T1,394,399,0.987468672,5,10,0.166666667,0.8,141
sub-2149_ses-T1,347,360,0.963888889,13,26,0.433333333,0.8,142
sub-2150_ses-T1,359,360,0.997222222,1,2,0.033333333,0.8,143
sub-2150_ses-T2,344,360,0.955555556,16,32,0.533333333,0.8,144
sub-2151_ses-T1,694,720,0.963888889,26,52,0.866666667,0.8,145
sub-2151_ses-T2,724,773,0.936610608,49,98,1.633333333,0.8,146
sub-2152_ses-T1,359,360,0.997222222,1,2,0.033333333,0.8,147
sub-2152_ses-T2,345,360,0.958333333,15,30,0.5,0.8,148
sub-2153_ses-T1,379,383,0.989556136,4,8,0.133333333,0.8,149
sub-2154_ses-T2,358,360,0.994444444,2,4,0.066666667,0.8,150
sub-2155_ses-T1,352,360,0.977777778,8,16,0.266666667,0.8,151
sub-2156_ses-T1,324,360,0.9,36,72,1.2,0.8,152
sub-2157_ses-T1,354,360,0.983333333,6,12,0.2,0.8,153
sub-2158_ses-T1,348,360,0.966666667,12,24,0.4,0.8,154
sub-2159_ses-T1,334,360,0.927777778,26,52,0.866666667,0.8,155
sub-2160_ses-T1,335,360,0.930555556,25,50,0.833333333,0.8,156
sub-2161_ses-T1,352,360,0.977777778,8,16,0.266666667,0.8,157
sub-2162_ses-T1,355,360,0.986111111,5,10,0.166666667,0.8,158
sub-2163_ses-T1,390,399,0.977443609,9,18,0.3,0.8,159
sub-2164_ses-T1,482,720,0.669444444,238,476,7.933333333,0.8,160
sub-2164_ses-T2,626,720,0.869444444,94,188,3.133333333,0.8,161
sub-2165_ses-T1,442,481,0.918918919,39,78,1.3,0.8,162
sub-2166_ses-T1,354,360,0.983333333,6,12,0.2,0.8,163
sub-2166_ses-T2,306,360,0.85,54,108,1.8,0.8,164
sub-2167_ses-T1,363,370,0.981081081,7,14,0.233333333,0.8,165
sub-2168_ses-T1,355,360,0.986111111,5,10,0.166666667,0.8,166
sub-2168_ses-T2,345,360,0.958333333,15,30,0.5,0.8,167
sub-2169_ses-T1,357,360,0.991666667,3,6,0.1,0.8,168
sub-2169_ses-T2,333,360,0.925,27,54,0.9,0.8,169
sub-2170_ses-T1,235,264,0.890151515,29,58,0.966666667,0.8,170
sub-2171_ses-T1,367,374,0.981283422,7,14,0.233333333,0.8,171
sub-2171_ses-T2,392,483,0.811594203,91,182,3.033333333,0.8,172
sub-2171_ses-T3,453,577,0.785095321,124,248,4.133333333,0.8,173
sub-2172_ses-T1,458,513,0.892787524,55,110,1.833333333,0.8,174
sub-2172_ses-T2,379,386,0.981865285,7,14,0.233333333,0.8,175
sub-2173_ses-T1,308,360,0.855555556,52,104,1.733333333,0.8,176
sub-2174_ses-T1,391,416,0.939903846,25,50,0.833333333,0.8,177
sub-2175_ses-T1,668,679,0.983799705,11,22,0.366666667,0.8,178
sub-2176_ses-T1,265,360,0.736111111,95,190,3.166666667,0.8,179
sub-2176_ses-T2,102,360,0.283333333,258,516,8.6,0.8,180
sub-2177_ses-T1,688,695,0.989928058,7,14,0.233333333,0.8,181
sub-2177_ses-T2,730,736,0.991847826,6,12,0.2,0.8,182
sub-2178_ses-T2,335,360,0.930555556,25,50,0.833333333,0.8,183
sub-2179_ses-T2,692,720,0.961111111,28,56,0.933333333,0.8,184
sub-2180_ses-T1,305,360,0.847222222,55,110,1.833333333,0.8,185
sub-2180_ses-T2,178,360,0.494444444,182,364,6.066666667,0.8,186
sub-2181_ses-T1,356,360,0.988888889,4,8,0.133333333,0.8,187
sub-2182_ses-T1,49,51,0.960784314,2,4,0.066666667,0.8,188
sub-2184_ses-T1,376,391,0.961636829,15,30,0.5,0.8,189
sub-2185_ses-T1,356,360,0.988888889,4,8,0.133333333,0.8,190
sub-2186_ses-T1,326,371,0.878706199,45,90,1.5,0.8,191
sub-2187_ses-T1,45,48,0.9375,3,6,0.1,0.8,192
sub-2188_ses-T1,436,445,0.979775281,9,18,0.3,0.8,193
sub-2189_ses-T1,198,204,0.970588235,6,12,0.2,0.8,194
sub-2190_ses-T1,330,360,0.916666667,30,60,1,0.8,195
sub-2191_ses-T1,358,360,0.994444444,2,4,0.066666667,0.8,196
sub-2191_ses-T2,294,360,0.816666667,66,132,2.2,0.8,197
sub-2192_ses-T1,359,360,0.997222222,1,2,0.033333333,0.8,198
sub-2193_ses-T2,613,625,0.9808,12,24,0.4,0.8,199
sub-2194_ses-T1,404,415,0.973493976,11,22,0.366666667,0.8,200
sub-2195_ses-T1,171,360,0.475,189,378,6.3,0.8,201
sub-2196_ses-T1,357,416,0.858173077,59,118,1.966666667,0.8,202
sub-2197_ses-T1,423,439,0.963553531,16,32,0.533333333,0.8,203
sub-2197_ses-T2,341,384,0.888020833,43,86,1.433333333,0.8,204
sub-2198_ses-T1,395,407,0.970515971,12,24,0.4,0.8,205
sub-2199_ses-T1,395,404,0.977722772,9,18,0.3,0.8,206
sub-2200_ses-T1,334,360,0.927777778,26,52,0.866666667,0.8,207
sub-2201_ses-T1,355,360,0.986111111,5,10,0.166666667,0.8,208
sub-2202_ses-T1,551,606,0.909240924,55,110,1.833333333,0.8,209
sub-2203_ses-T1,335,360,0.930555556,25,50,0.833333333,0.8,210
sub-2204_ses-T1,345,360,0.958333333,15,30,0.5,0.8,211
sub-2204_ses-T2,357,360,0.991666667,3,6,0.1,0.8,212
sub-2205_ses-T1,354,360,0.983333333,6,12,0.2,0.8,213
sub-2206_ses-T1,357,360,0.991666667,3,6,0.1,0.8,214
sub-2206_ses-T2,644,720,0.894444444,76,152,2.533333333,0.8,215
sub-2207_ses-T1,297,360,0.825,63,126,2.1,0.8,216
sub-2207_ses-T2,323,360,0.897222222,37,74,1.233333333,0.8,217
sub-2208_ses-T1,345,360,0.958333333,15,30,0.5,0.8,218
sub-2208_ses-T2,327,360,0.908333333,33,66,1.1,0.8,219
sub-2209_ses-T1,335,341,0.982404692,6,12,0.2,0.8,220
sub-2210_ses-T1,34,38,0.894736842,4,8,0.133333333,0.8,221
sub-2211_ses-T1,357,360,0.991666667,3,6,0.1,0.8,222
sub-2212_ses-T1,358,360,0.994444444,2,4,0.066666667,0.8,223
sub-2213_ses-T1,263,286,0.91958042,23,46,0.766666667,0.8,224
sub-2214_ses-T1,370,373,0.991957105,3,6,0.1,0.8,225
sub-2215_ses-T1,356,360,0.988888889,4,8,0.133333333,0.8,226
sub-2216_ses-T1,71,86,0.825581395,15,30,0.5,0.8,227
sub-2216_ses-T2,140,181,0.773480663,41,82,1.366666667,0.8,228
sub-2217_ses-T1,285,360,0.791666667,75,150,2.5,0.8,229
sub-2217_ses-T2,106,360,0.294444444,254,508,8.466666667,0.8,230
sub-2218_ses-T1,346,360,0.961111111,14,28,0.466666667,0.8,231
sub-2218_ses-T2,568,720,0.788888889,152,304,5.066666667,0.8,232
sub-2219_ses-T1,359,360,0.997222222,1,2,0.033333333,0.8,233
sub-2220_ses-T1,358,360,0.994444444,2,4,0.066666667,0.8,234
sub-2220_ses-T2,656,720,0.911111111,64,128,2.133333333,0.8,235
sub-2221_ses-T1,314,360,0.872222222,46,92,1.533333333,0.8,236
sub-2221_ses-T2,656,720,0.911111111,64,128,2.133333333,0.8,237
sub-2222_ses-T1,335,360,0.930555556,25,50,0.833333333,0.8,238
sub-2223_ses-T1,355,360,0.986111111,5,10,0.166666667,0.8,239
sub-2223_ses-T2,632,720,0.877777778,88,176,2.933333333,0.8,240
sub-2224_ses-T1,337,379,0.889182058,42,84,1.4,0.8,241
sub-2225_ses-T1,355,360,0.986111111,5,10,0.166666667,0.8,242
sub-2225_ses-T2,723,759,0.95256917,36,72,1.2,0.8,243
sub-2226_ses-T1,301,365,0.824657534,64,128,2.133333333,0.8,244
sub-2226_ses-T2,302,360,0.838888889,58,116,1.933333333,0.8,245
sub-2227_ses-T1,356,360,0.988888889,4,8,0.133333333,0.8,246
sub-2228_ses-T1,358,360,0.994444444,2,4,0.066666667,0.8,247
sub-2228_ses-T2,690,729,0.946502058,39,78,1.3,0.8,248
sub-2229_ses-T1,358,360,0.994444444,2,4,0.066666667,0.8,249
sub-2229_ses-T2,365,390,0.935897436,25,50,0.833333333,0.8,250
sub-2230_ses-T1,389,398,0.977386935,9,18,0.3,0.8,251
sub-7001_ses-f2,497,720,0.690277778,223,446,7.433333333,0.8,252
sub-7001_ses-f3,228,720,0.316666667,492,984,16.4,0.8,253
sub-7002_ses-f1,669,720,0.929166667,51,102,1.7,0.8,254
sub-7002_ses-f2,621,720,0.8625,99,198,3.3,0.8,255
sub-7003_ses-f1,345,360,0.958333333,15,30,0.5,0.8,256
sub-7003_ses-f2,73,180,0.405555556,107,214,3.566666667,0.8,257
sub-7004_ses-f3,585,724,0.80801105,139,278,4.633333333,0.8,258
sub-7006_ses-f1,48,52,0.923076923,4,8,0.133333333,0.8,259
sub-7008_ses-f1,699,720,0.970833333,21,42,0.7,0.8,260
sub-7008_ses-f2,354,720,0.491666667,366,732,12.2,0.8,261
sub-7009_ses-f1,659,720,0.915277778,61,122,2.033333333,0.8,262
sub-7009_ses-f2,478,720,0.663888889,242,484,8.066666667,0.8,263
sub-7011_ses-f1,912,917,0.994547437,5,10,0.166666667,0.8,264
sub-7011_ses-f2,344,360,0.955555556,16,32,0.533333333,0.8,265
sub-7012_ses-f1,751,761,0.986859396,10,20,0.333333333,0.8,266
sub-7012_ses-f2,679,720,0.943055556,41,82,1.366666667,0.8,267
sub-7014_ses-f1,346,360,0.961111111,14,28,0.466666667,0.8,268
sub-7014_ses-f2,708,720,0.983333333,12,24,0.4,0.8,269
sub-7015_ses-f1,786,832,0.944711538,46,92,1.533333333,0.8,270
sub-7015_ses-f2,666,729,0.913580247,63,126,2.1,0.8,271
sub-7016_ses-f1,711,750,0.948,39,78,1.3,0.8,272
sub-7016_ses-f2,343,720,0.476388889,377,754,12.56666667,0.8,273
sub-7017_ses-f1,736,740,0.994594595,4,8,0.133333333,0.8,274
sub-7017_ses-f2,712,725,0.982068966,13,26,0.433333333,0.8,275
sub-7020_ses-f1,704,740,0.951351351,36,72,1.2,0.8,276
sub-7020_ses-f2,534,720,0.741666667,186,372,6.2,0.8,277
sub-7021_ses-f1,748,753,0.993359894,5,10,0.166666667,0.8,278
sub-7022_ses-f1,715,720,0.993055556,5,10,0.166666667,0.8,279
sub-7022_ses-f2,721,727,0.991746905,6,12,0.2,0.8,280
sub-7023_ses-f1,723,744,0.971774194,21,42,0.7,0.8,281
sub-7023_ses-f2,799,829,0.963811821,30,60,1,0.8,282
sub-7024_ses-f1,721,728,0.990384615,7,14,0.233333333,0.8,283
sub-7025_ses-f1,702,729,0.962962963,27,54,0.9,0.8,284
sub-7025_ses-f2,575,760,0.756578947,185,370,6.166666667,0.8,285
sub-7026_ses-f1,881,920,0.957608696,39,78,1.3,0.8,286
sub-7026_ses-f2,888,914,0.971553611,26,52,0.866666667,0.8,287
sub-7026_ses-f3,453,731,0.619699042,278,556,9.266666667,0.8,288
sub-7027_ses-f1,880,885,0.994350282,5,10,0.166666667,0.8,289
sub-7027_ses-f2,356,410,0.868292683,54,108,1.8,0.8,290
sub-7027_ses-f3,626,725,0.863448276,99,198,3.3,0.8,291
sub-7028_ses-f1,749,752,0.996010638,3,6,0.1,0.8,292
sub-7028_ses-f2,716,720,0.994444444,4,8,0.133333333,0.8,293
sub-7029_ses-f1,700,731,0.957592339,31,62,1.033333333,0.8,294
sub-7029_ses-f2,641,725,0.884137931,84,168,2.8,0.8,295
sub-7030_ses-f1,632,720,0.877777778,88,176,2.933333333,0.8,296
sub-7030_ses-f2,662,794,0.833753149,132,264,4.4,0.8,297
sub-7031_ses-f1,85,192,0.442708333,107,214,3.566666667,0.8,298
sub-7031_ses-f2,189,374,0.505347594,185,370,6.166666667,0.8,299
sub-7031_ses-f3,699,737,0.94843962,38,76,1.266666667,0.8,300
sub-7032_ses-f1,718,720,0.997222222,2,4,0.066666667,0.8,301
sub-7032_ses-f2,69,73,0.945205479,4,8,0.133333333,0.8,302
sub-7032_ses-f3,725,740,0.97972973,15,30,0.5,0.8,303
sub-7033_ses-f2,540,752,0.718085106,212,424,7.066666667,0.8,304
sub-7034_ses-f1,745,760,0.980263158,15,30,0.5,0.8,305
sub-7034_ses-f2,847,912,0.92872807,65,130,2.166666667,0.8,306
sub-7034_ses-f3,467,728,0.641483516,261,522,8.7,0.8,307
sub-7035_ses-f1,40,50,0.8,10,20,0.333333333,0.8,308
sub-7035_ses-f2,610,727,0.839064649,117,234,3.9,0.8,309
sub-7036_ses-f1,677,745,0.908724832,68,136,2.266666667,0.8,310
sub-7037_ses-f1,769,772,0.99611399,3,6,0.1,0.8,311
sub-7037_ses-f2,843,852,0.98943662,9,18,0.3,0.8,312
sub-7037_ses-f3,699,720,0.970833333,21,42,0.7,0.8,313
sub-7038_ses-f1,733,789,0.929024081,56,112,1.866666667,0.8,314
sub-7038_ses-f2,544,785,0.692993631,241,482,8.033333333,0.8,315
sub-7039_ses-f1,724,785,0.922292994,61,122,2.033333333,0.8,316
sub-7039_ses-f2,644,727,0.885832187,83,166,2.766666667,0.8,317
sub-7040_ses-f1,633,728,0.869505495,95,190,3.166666667,0.8,318
sub-7040_ses-f2,594,720,0.825,126,252,4.2,0.8,319
sub-7040_ses-f3,545,720,0.756944444,175,350,5.833333333,0.8,320
sub-7041_ses-f1,747,754,0.99071618,7,14,0.233333333,0.8,321
sub-7041_ses-f2,604,735,0.821768707,131,262,4.366666667,0.8,322
sub-7042_ses-f3,557,658,0.846504559,101,202,3.366666667,0.8,323
sub-7043_ses-f2,936,1080,0.866666667,144,288,4.8,0.8,324
sub-7044_ses-f2,697,739,0.943166441,42,84,1.4,0.8,325
sub-7045_ses-f1,791,823,0.961117861,32,64,1.066666667,0.8,326
sub-7046_ses-f1,788,812,0.97044335,24,48,0.8,0.8,327
sub-7046_ses-f2,38,61,0.62295082,23,46,0.766666667,0.8,328
sub-7046_ses-f3,673,741,0.908232119,68,136,2.266666667,0.8,329
sub-7047_ses-f1,717,720,0.995833333,3,6,0.1,0.8,330
sub-7047_ses-f2,40,64,0.625,24,48,0.8,0.8,331
sub-7048_ses-f1,5,6,0.833333333,1,2,0.033333333,0.8,332
sub-7048_ses-f2,329,360,0.913888889,31,62,1.033333333,0.8,333
sub-7049_ses-f1,326,360,0.905555556,34,68,1.133333333,0.8,334
sub-7052_ses-f1,485,518,0.936293436,33,66,1.1,0.8,335
sub-7053_ses-f1,701,720,0.973611111,19,38,0.633333333,0.8,336
sub-7054_ses-f1,706,766,0.921671018,60,120,2,0.8,337
sub-2006_ses-T1,339,420,0.807142857,81,162,2.7,0.9,1
sub-2011_ses-T1,320,360,0.888888889,40,80,1.333333333,0.9,2
sub-2012_ses-T1,179,180,0.994444444,1,2,0.033333333,0.9,3
sub-2013_ses-T1,311,360,0.863888889,49,98,1.633333333,0.9,4
sub-2014_ses-T1,349,360,0.969444444,11,22,0.366666667,0.9,5
sub-2015_ses-T1,83,180,0.461111111,97,194,3.233333333,0.9,6
sub-2016_ses-T1,347,360,0.963888889,13,26,0.433333333,0.9,7
sub-2017_ses-T1,179,180,0.994444444,1,2,0.033333333,0.9,8
sub-2018_ses-T1,163,180,0.905555556,17,34,0.566666667,0.9,9
sub-2019_ses-T1,348,360,0.966666667,12,24,0.4,0.9,10
sub-2020_ses-T1,19,26,0.730769231,7,14,0.233333333,0.9,11
sub-2020_ses-T2,307,360,0.852777778,53,106,1.766666667,0.9,12
sub-2021_ses-T1,329,360,0.913888889,31,62,1.033333333,0.9,13
sub-2022_ses-T1,314,360,0.872222222,46,92,1.533333333,0.9,14
sub-2023_ses-T1,204,360,0.566666667,156,312,5.2,0.9,15
sub-2024_ses-T2,11,12,0.916666667,1,2,0.033333333,0.9,16
sub-2026_ses-T1,211,223,0.946188341,12,24,0.4,0.9,17
sub-2027_ses-T1,358,360,0.994444444,2,4,0.066666667,0.9,18
sub-2028_ses-T1,300,360,0.833333333,60,120,2,0.9,19
sub-2029_ses-T1,342,360,0.95,18,36,0.6,0.9,20
sub-2030_ses-T1,275,360,0.763888889,85,170,2.833333333,0.9,21
sub-2031_ses-T1,357,360,0.991666667,3,6,0.1,0.9,22
sub-2032_ses-T1,258,360,0.716666667,102,204,3.4,0.9,23
sub-2033_ses-T1,354,360,0.983333333,6,12,0.2,0.9,24
sub-2033_ses-T2,217,360,0.602777778,143,286,4.766666667,0.9,25
sub-2034_ses-T1,107,180,0.594444444,73,146,2.433333333,0.9,26
sub-2035_ses-T1,358,360,0.994444444,2,4,0.066666667,0.9,27
sub-2036_ses-T1,354,360,0.983333333,6,12,0.2,0.9,28
sub-2037_ses-T1,344,360,0.955555556,16,32,0.533333333,0.9,29
sub-2038_ses-T1,357,360,0.991666667,3,6,0.1,0.9,30
sub-2039_ses-T1,179,180,0.994444444,1,2,0.033333333,0.9,31
sub-2040_ses-T1,350,360,0.972222222,10,20,0.333333333,0.9,32
sub-2041_ses-T1,354,360,0.983333333,6,12,0.2,0.9,33
sub-2042_ses-T1,166,180,0.922222222,14,28,0.466666667,0.9,34
sub-2043_ses-T1,217,360,0.602777778,143,286,4.766666667,0.9,35
sub-2044_ses-T1,294,360,0.816666667,66,132,2.2,0.9,36
sub-2045_ses-T1,142,180,0.788888889,38,76,1.266666667,0.9,37
sub-2046_ses-T1,171,180,0.95,9,18,0.3,0.9,38
sub-2047_ses-T1,162,180,0.9,18,36,0.6,0.9,39
sub-2048_ses-T1,175,180,0.972222222,5,10,0.166666667,0.9,40
sub-2049_ses-T1,347,360,0.963888889,13,26,0.433333333,0.9,41
sub-2051_ses-T1,357,360,0.991666667,3,6,0.1,0.9,42
sub-2051_ses-T2,358,360,0.994444444,2,4,0.066666667,0.9,43
sub-2052_ses-T1,317,360,0.880555556,43,86,1.433333333,0.9,44
sub-2052_ses-T2,122,180,0.677777778,58,116,1.933333333,0.9,45
sub-2053_ses-T1,256,360,0.711111111,104,208,3.466666667,0.9,46
sub-2055_ses-T1,115,180,0.638888889,65,130,2.166666667,0.9,47
sub-2056_ses-T1,358,360,0.994444444,2,4,0.066666667,0.9,48
sub-2057_ses-T1,356,360,0.988888889,4,8,0.133333333,0.9,49
sub-2058_ses-T1,281,360,0.780555556,79,158,2.633333333,0.9,50
sub-2059_ses-T1,270,360,0.75,90,180,3,0.9,51
sub-2061_ses-T1,131,180,0.727777778,49,98,1.633333333,0.9,52
sub-2062_ses-T1,354,360,0.983333333,6,12,0.2,0.9,53
sub-2063_ses-T1,326,360,0.905555556,34,68,1.133333333,0.9,54
sub-2064_ses-T1,171,180,0.95,9,18,0.3,0.9,55
sub-2065_ses-T1,132,180,0.733333333,48,96,1.6,0.9,56
sub-2066_ses-T1,172,180,0.955555556,8,16,0.266666667,0.9,57
sub-2066_ses-T2,345,360,0.958333333,15,30,0.5,0.9,58
sub-2067_ses-T1,349,360,0.969444444,11,22,0.366666667,0.9,59
sub-2068_ses-T1,346,360,0.961111111,14,28,0.466666667,0.9,60
sub-2069_ses-T1,334,360,0.927777778,26,52,0.866666667,0.9,61
sub-2070_ses-T1,327,360,0.908333333,33,66,1.1,0.9,62
sub-2071_ses-T1,343,360,0.952777778,17,34,0.566666667,0.9,63
sub-2072_ses-T1,348,360,0.966666667,12,24,0.4,0.9,64
sub-2073_ses-T1,252,256,0.984375,4,8,0.133333333,0.9,65
sub-2073_ses-T2,155,180,0.861111111,25,50,0.833333333,0.9,66
sub-2074_ses-T1,132,180,0.733333333,48,96,1.6,0.9,67
sub-2075_ses-T1,177,180,0.983333333,3,6,0.1,0.9,68
sub-2076_ses-T1,288,360,0.8,72,144,2.4,0.9,69
sub-2076_ses-T2,207,360,0.575,153,306,5.1,0.9,70
sub-2077_ses-T1,358,360,0.994444444,2,4,0.066666667,0.9,71
sub-2078_ses-T1,356,360,0.988888889,4,8,0.133333333,0.9,72
sub-2079_ses-T1,349,360,0.969444444,11,22,0.366666667,0.9,73
sub-2079_ses-T2,258,360,0.716666667,102,204,3.4,0.9,74
sub-2080_ses-T1,234,360,0.65,126,252,4.2,0.9,75
sub-2081_ses-T1,356,360,0.988888889,4,8,0.133333333,0.9,76
sub-2082_ses-T1,319,360,0.886111111,41,82,1.366666667,0.9,77
sub-2083_ses-T1,235,360,0.652777778,125,250,4.166666667,0.9,78
sub-2084_ses-T1,357,360,0.991666667,3,6,0.1,0.9,79
sub-2085_ses-T1,328,360,0.911111111,32,64,1.066666667,0.9,80
sub-2086_ses-T1,187,360,0.519444444,173,346,5.766666667,0.9,81
sub-2087_ses-T1,354,360,0.983333333,6,12,0.2,0.9,82
sub-2088_ses-T1,346,360,0.961111111,14,28,0.466666667,0.9,83
sub-2089_ses-T1,179,180,0.994444444,1,2,0.033333333,0.9,84
sub-2091_ses-T1,278,360,0.772222222,82,164,2.733333333,0.9,85
sub-2092_ses-T1,334,360,0.927777778,26,52,0.866666667,0.9,86
sub-2093_ses-T1,347,360,0.963888889,13,26,0.433333333,0.9,87
sub-2094_ses-T1,173,180,0.961111111,7,14,0.233333333,0.9,88
sub-2095_ses-T1,357,360,0.991666667,3,6,0.1,0.9,89
sub-2096_ses-T1,340,360,0.944444444,20,40,0.666666667,0.9,90
sub-2097_ses-T1,528,540,0.977777778,12,24,0.4,0.9,91
sub-2098_ses-T1,275,360,0.763888889,85,170,2.833333333,0.9,92
sub-2099_ses-T1,176,180,0.977777778,4,8,0.133333333,0.9,93
sub-2099_ses-T2,345,360,0.958333333,15,30,0.5,0.9,94
sub-2100_ses-T1,164,180,0.911111111,16,32,0.533333333,0.9,95
sub-2100_ses-T2,312,360,0.866666667,48,96,1.6,0.9,96
sub-2101_ses-T1,326,360,0.905555556,34,68,1.133333333,0.9,97
sub-2101_ses-T2,280,360,0.777777778,80,160,2.666666667,0.9,98
sub-2102_ses-T1,355,360,0.986111111,5,10,0.166666667,0.9,99
sub-2103_ses-T1,333,360,0.925,27,54,0.9,0.9,100
sub-2103_ses-T2,357,360,0.991666667,3,6,0.1,0.9,101
sub-2104_ses-T1,380,387,0.981912145,7,14,0.233333333,0.9,102
sub-2105_ses-T1,356,360,0.988888889,4,8,0.133333333,0.9,103
sub-2105_ses-T2,357,360,0.991666667,3,6,0.1,0.9,104
sub-2106_ses-T1,358,360,0.994444444,2,4,0.066666667,0.9,105
sub-2107_ses-T1,272,360,0.755555556,88,176,2.933333333,0.9,106
sub-2107_ses-T2,292,360,0.811111111,68,136,2.266666667,0.9,107
sub-2108_ses-T1,358,360,0.994444444,2,4,0.066666667,0.9,108
sub-2108_ses-T3,138,141,0.978723404,3,6,0.1,0.9,109
sub-2109_ses-T1,174,180,0.966666667,6,12,0.2,0.9,110
sub-2110_ses-T1,268,274,0.97810219,6,12,0.2,0.9,111
sub-2115_ses-T1,353,360,0.980555556,7,14,0.233333333,0.9,112
sub-2115_ses-T2,346,360,0.961111111,14,28,0.466666667,0.9,113
sub-2117_ses-T1,351,360,0.975,9,18,0.3,0.9,114
sub-2117_ses-T2,285,360,0.791666667,75,150,2.5,0.9,115
sub-2118_ses-T1,307,360,0.852777778,53,106,1.766666667,0.9,116
sub-2120_ses-T1,351,360,0.975,9,18,0.3,0.9,117
sub-2122_ses-T1,343,360,0.952777778,17,34,0.566666667,0.9,118
sub-2123_ses-T1,351,360,0.975,9,18,0.3,0.9,119
sub-2124_ses-T1,346,404,0.856435644,58,116,1.933333333,0.9,120
sub-2126_ses-T1,342,360,0.95,18,36,0.6,0.9,121
sub-2128_ses-T1,348,360,0.966666667,12,24,0.4,0.9,122
sub-2133_ses-T1,333,360,0.925,27,54,0.9,0.9,123
sub-2135_ses-T1,8,19,0.421052632,11,22,0.366666667,0.9,124
sub-2136_ses-T1,622,720,0.863888889,98,196,3.266666667,0.9,125
sub-2137_ses-T1,662,720,0.919444444,58,116,1.933333333,0.9,126
sub-2137_ses-T2,182,360,0.505555556,178,356,5.933333333,0.9,127
sub-2138_ses-T1,357,360,0.991666667,3,6,0.1,0.9,128
sub-2139_ses-T1,264,360,0.733333333,96,192,3.2,0.9,129
sub-2140_ses-T1,377,379,0.994722955,2,4,0.066666667,0.9,130
sub-2141_ses-T1,298,360,0.827777778,62,124,2.066666667,0.9,131
sub-2142_ses-T2,358,360,0.994444444,2,4,0.066666667,0.9,132
sub-2143_ses-T1,321,360,0.891666667,39,78,1.3,0.9,133
sub-2144_ses-T1,335,372,0.900537634,37,74,1.233333333,0.9,134
sub-2145_ses-T1,323,360,0.897222222,37,74,1.233333333,0.9,135
sub-2145_ses-T2,250,360,0.694444444,110,220,3.666666667,0.9,136
sub-2146_ses-T1,355,360,0.986111111,5,10,0.166666667,0.9,137
sub-2146_ses-T2,644,720,0.894444444,76,152,2.533333333,0.9,138
sub-2147_ses-T1,332,360,0.922222222,28,56,0.933333333,0.9,139
sub-2147_ses-T2,345,360,0.958333333,15,30,0.5,0.9,140
sub-2148_ses-T1,393,399,0.984962406,6,12,0.2,0.9,141
sub-2149_ses-T1,344,360,0.955555556,16,32,0.533333333,0.9,142
sub-2150_ses-T1,359,360,0.997222222,1,2,0.033333333,0.9,143
sub-2150_ses-T2,340,360,0.944444444,20,40,0.666666667,0.9,144
sub-2151_ses-T1,688,720,0.955555556,32,64,1.066666667,0.9,145
sub-2151_ses-T2,699,773,0.904269082,74,148,2.466666667,0.9,146
sub-2152_ses-T1,359,360,0.997222222,1,2,0.033333333,0.9,147
sub-2152_ses-T2,338,360,0.938888889,22,44,0.733333333,0.9,148
sub-2153_ses-T1,379,383,0.989556136,4,8,0.133333333,0.9,149
sub-2154_ses-T2,358,360,0.994444444,2,4,0.066666667,0.9,150
sub-2155_ses-T1,349,360,0.969444444,11,22,0.366666667,0.9,151
sub-2156_ses-T1,312,360,0.866666667,48,96,1.6,0.9,152
sub-2157_ses-T1,354,360,0.983333333,6,12,0.2,0.9,153
sub-2158_ses-T1,341,360,0.947222222,19,38,0.633333333,0.9,154
sub-2159_ses-T1,324,360,0.9,36,72,1.2,0.9,155
sub-2160_ses-T1,325,360,0.902777778,35,70,1.166666667,0.9,156
sub-2161_ses-T1,347,360,0.963888889,13,26,0.433333333,0.9,157
sub-2162_ses-T1,353,360,0.980555556,7,14,0.233333333,0.9,158
sub-2163_ses-T1,388,399,0.972431078,11,22,0.366666667,0.9,159
sub-2164_ses-T1,430,720,0.597222222,290,580,9.666666667,0.9,160
sub-2164_ses-T2,608,720,0.844444444,112,224,3.733333333,0.9,161
sub-2165_ses-T1,425,481,0.883575884,56,112,1.866666667,0.9,162
sub-2166_ses-T1,352,360,0.977777778,8,16,0.266666667,0.9,163
sub-2166_ses-T2,291,360,0.808333333,69,138,2.3,0.9,164
sub-2167_ses-T1,361,370,0.975675676,9,18,0.3,0.9,165
sub-2168_ses-T1,354,360,0.983333333,6,12,0.2,0.9,166
sub-2168_ses-T2,341,360,0.947222222,19,38,0.633333333,0.9,167
sub-2169_ses-T1,357,360,0.991666667,3,6,0.1,0.9,168
sub-2169_ses-T2,323,360,0.897222222,37,74,1.233333333,0.9,169
sub-2170_ses-T1,226,264,0.856060606,38,76,1.266666667,0.9,170
sub-2171_ses-T1,361,374,0.965240642,13,26,0.433333333,0.9,171
sub-2171_ses-T2,377,483,0.780538302,106,212,3.533333333,0.9,172
sub-2171_ses-T3,418,577,0.724436742,159,318,5.3,0.9,173
sub-2172_ses-T1,443,513,0.863547758,70,140,2.333333333,0.9,174
sub-2172_ses-T2,376,386,0.974093264,10,20,0.333333333,0.9,175
sub-2173_ses-T1,290,360,0.805555556,70,140,2.333333333,0.9,176
sub-2174_ses-T1,381,416,0.915865385,35,70,1.166666667,0.9,177
sub-2175_ses-T1,667,679,0.982326951,12,24,0.4,0.9,178
sub-2176_ses-T1,243,360,0.675,117,234,3.9,0.9,179
sub-2176_ses-T2,78,360,0.216666667,282,564,9.4,0.9,180
sub-2177_ses-T1,688,695,0.989928058,7,14,0.233333333,0.9,181
sub-2177_ses-T2,724,736,0.983695652,12,24,0.4,0.9,182
sub-2178_ses-T2,313,360,0.869444444,47,94,1.566666667,0.9,183
sub-2179_ses-T2,680,720,0.944444444,40,80,1.333333333,0.9,184
sub-2180_ses-T1,290,360,0.805555556,70,140,2.333333333,0.9,185
sub-2180_ses-T2,159,360,0.441666667,201,402,6.7,0.9,186
sub-2181_ses-T1,353,360,0.980555556,7,14,0.233333333,0.9,187
sub-2182_ses-T1,48,51,0.941176471,3,6,0.1,0.9,188
sub-2184_ses-T1,373,391,0.953964194,18,36,0.6,0.9,189
sub-2185_ses-T1,355,360,0.986111111,5,10,0.166666667,0.9,190
sub-2186_ses-T1,310,371,0.835579515,61,122,2.033333333,0.9,191
sub-2187_ses-T1,45,48,0.9375,3,6,0.1,0.9,192
sub-2188_ses-T1,436,445,0.979775281,9,18,0.3,0.9,193
sub-2189_ses-T1,197,204,0.965686275,7,14,0.233333333,0.9,194
sub-2190_ses-T1,317,360,0.880555556,43,86,1.433333333,0.9,195
sub-2191_ses-T1,358,360,0.994444444,2,4,0.066666667,0.9,196
sub-2191_ses-T2,259,360,0.719444444,101,202,3.366666667,0.9,197
sub-2192_ses-T1,359,360,0.997222222,1,2,0.033333333,0.9,198
sub-2193_ses-T2,607,625,0.9712,18,36,0.6,0.9,199
sub-2194_ses-T1,400,415,0.963855422,15,30,0.5,0.9,200
sub-2195_ses-T1,148,360,0.411111111,212,424,7.066666667,0.9,201
sub-2196_ses-T1,341,416,0.819711538,75,150,2.5,0.9,202
sub-2197_ses-T1,417,439,0.949886105,22,44,0.733333333,0.9,203
sub-2197_ses-T2,332,384,0.864583333,52,104,1.733333333,0.9,204
sub-2198_ses-T1,393,407,0.965601966,14,28,0.466666667,0.9,205
sub-2199_ses-T1,393,404,0.972772277,11,22,0.366666667,0.9,206
sub-2200_ses-T1,319,360,0.886111111,41,82,1.366666667,0.9,207
sub-2201_ses-T1,352,360,0.977777778,8,16,0.266666667,0.9,208
sub-2202_ses-T1,532,606,0.877887789,74,148,2.466666667,0.9,209
sub-2203_ses-T1,327,360,0.908333333,33,66,1.1,0.9,210
sub-2204_ses-T1,342,360,0.95,18,36,0.6,0.9,211
sub-2204_ses-T2,353,360,0.980555556,7,14,0.233333333,0.9,212
sub-2205_ses-T1,350,360,0.972222222,10,20,0.333333333,0.9,213
sub-2206_ses-T1,356,360,0.988888889,4,8,0.133333333,0.9,214
sub-2206_ses-T2,606,720,0.841666667,114,228,3.8,0.9,215
sub-2207_ses-T1,278,360,0.772222222,82,164,2.733333333,0.9,216
sub-2207_ses-T2,302,360,0.838888889,58,116,1.933333333,0.9,217
sub-2208_ses-T1,342,360,0.95,18,36,0.6,0.9,218
sub-2208_ses-T2,315,360,0.875,45,90,1.5,0.9,219
sub-2209_ses-T1,335,341,0.982404692,6,12,0.2,0.9,220
sub-2210_ses-T1,34,38,0.894736842,4,8,0.133333333,0.9,221
sub-2211_ses-T1,356,360,0.988888889,4,8,0.133333333,0.9,222
sub-2212_ses-T1,358,360,0.994444444,2,4,0.066666667,0.9,223
sub-2213_ses-T1,260,286,0.909090909,26,52,0.866666667,0.9,224
sub-2214_ses-T1,369,373,0.989276139,4,8,0.133333333,0.9,225
sub-2215_ses-T1,356,360,0.988888889,4,8,0.133333333,0.9,226
sub-2216_ses-T1,69,86,0.802325581,17,34,0.566666667,0.9,227
sub-2216_ses-T2,131,181,0.723756906,50,100,1.666666667,0.9,228
sub-2217_ses-T1,273,360,0.758333333,87,174,2.9,0.9,229
sub-2217_ses-T2,80,360,0.222222222,280,560,9.333333333,0.9,230
sub-2218_ses-T1,339,360,0.941666667,21,42,0.7,0.9,231
sub-2218_ses-T2,526,720,0.730555556,194,388,6.466666667,0.9,232
sub-2219_ses-T1,358,360,0.994444444,2,4,0.066666667,0.9,233
sub-2220_ses-T1,357,360,0.991666667,3,6,0.1,0.9,234
sub-2220_ses-T2,632,720,0.877777778,88,176,2.933333333,0.9,235
sub-2221_ses-T1,296,360,0.822222222,64,128,2.133333333,0.9,236
sub-2221_ses-T2,640,720,0.888888889,80,160,2.666666667,0.9,237
sub-2222_ses-T1,324,360,0.9,36,72,1.2,0.9,238
sub-2223_ses-T1,352,360,0.977777778,8,16,0.266666667,0.9,239
sub-2223_ses-T2,610,720,0.847222222,110,220,3.666666667,0.9,240
sub-2224_ses-T1,326,379,0.860158311,53,106,1.766666667,0.9,241
sub-2225_ses-T1,352,360,0.977777778,8,16,0.266666667,0.9,242
sub-2225_ses-T2,709,759,0.934123847,50,100,1.666666667,0.9,243
sub-2226_ses-T1,285,365,0.780821918,80,160,2.666666667,0.9,244
sub-2226_ses-T2,291,360,0.808333333,69,138,2.3,0.9,245
sub-2227_ses-T1,354,360,0.983333333,6,12,0.2,0.9,246
sub-2228_ses-T1,357,360,0.991666667,3,6,0.1,0.9,247
sub-2228_ses-T2,674,729,0.924554184,55,110,1.833333333,0.9,248
sub-2229_ses-T1,358,360,0.994444444,2,4,0.066666667,0.9,249
sub-2229_ses-T2,347,390,0.88974359,43,86,1.433333333,0.9,250
sub-2230_ses-T1,388,398,0.974874372,10,20,0.333333333,0.9,251
sub-7001_ses-f2,466,720,0.647222222,254,508,8.466666667,0.9,252
sub-7001_ses-f3,209,720,0.290277778,511,1022,17.03333333,0.9,253
sub-7002_ses-f1,651,720,0.904166667,69,138,2.3,0.9,254
sub-7002_ses-f2,584,720,0.811111111,136,272,4.533333333,0.9,255
sub-7003_ses-f1,338,360,0.938888889,22,44,0.733333333,0.9,256
sub-7003_ses-f2,54,180,0.3,126,252,4.2,0.9,257
sub-7004_ses-f3,552,724,0.762430939,172,344,5.733333333,0.9,258
sub-7006_ses-f1,48,52,0.923076923,4,8,0.133333333,0.9,259
sub-7008_ses-f1,687,720,0.954166667,33,66,1.1,0.9,260
sub-7008_ses-f2,312,720,0.433333333,408,816,13.6,0.9,261
sub-7009_ses-f1,633,720,0.879166667,87,174,2.9,0.9,262
sub-7009_ses-f2,423,720,0.5875,297,594,9.9,0.9,263
sub-7011_ses-f1,912,917,0.994547437,5,10,0.166666667,0.9,264
sub-7011_ses-f2,330,360,0.916666667,30,60,1,0.9,265
sub-7012_ses-f1,748,761,0.982917214,13,26,0.433333333,0.9,266
sub-7012_ses-f2,665,720,0.923611111,55,110,1.833333333,0.9,267
sub-7014_ses-f1,335,360,0.930555556,25,50,0.833333333,0.9,268
sub-7014_ses-f2,697,720,0.968055556,23,46,0.766666667,0.9,269
sub-7015_ses-f1,780,832,0.9375,52,104,1.733333333,0.9,270
sub-7015_ses-f2,641,729,0.879286694,88,176,2.933333333,0.9,271
sub-7016_ses-f1,701,750,0.934666667,49,98,1.633333333,0.9,272
sub-7016_ses-f2,297,720,0.4125,423,846,14.1,0.9,273
sub-7017_ses-f1,736,740,0.994594595,4,8,0.133333333,0.9,274
sub-7017_ses-f2,704,725,0.971034483,21,42,0.7,0.9,275
sub-7020_ses-f1,684,740,0.924324324,56,112,1.866666667,0.9,276
sub-7020_ses-f2,494,720,0.686111111,226,452,7.533333333,0.9,277
sub-7021_ses-f1,747,753,0.992031873,6,12,0.2,0.9,278
sub-7022_ses-f1,715,720,0.993055556,5,10,0.166666667,0.9,279
sub-7022_ses-f2,719,727,0.988995873,8,16,0.266666667,0.9,280
sub-7023_ses-f1,711,744,0.955645161,33,66,1.1,0.9,281
sub-7023_ses-f2,789,829,0.951749095,40,80,1.333333333,0.9,282
sub-7024_ses-f1,719,728,0.987637363,9,18,0.3,0.9,283
sub-7025_ses-f1,691,729,0.9478738,38,76,1.266666667,0.9,284
sub-7025_ses-f2,533,760,0.701315789,227,454,7.566666667,0.9,285
sub-7026_ses-f1,868,920,0.943478261,52,104,1.733333333,0.9,286
sub-7026_ses-f2,884,914,0.967177243,30,60,1,0.9,287
sub-7026_ses-f3,393,731,0.537619699,338,676,11.26666667,0.9,288
sub-7027_ses-f1,880,885,0.994350282,5,10,0.166666667,0.9,289
sub-7027_ses-f2,334,410,0.814634146,76,152,2.533333333,0.9,290
sub-7027_ses-f3,596,725,0.822068966,129,258,4.3,0.9,291
sub-7028_ses-f1,749,752,0.996010638,3,6,0.1,0.9,292
sub-7028_ses-f2,715,720,0.993055556,5,10,0.166666667,0.9,293
sub-7029_ses-f1,688,731,0.941176471,43,86,1.433333333,0.9,294
sub-7029_ses-f2,618,725,0.852413793,107,214,3.566666667,0.9,295
sub-7030_ses-f1,627,720,0.870833333,93,186,3.1,0.9,296
sub-7030_ses-f2,627,794,0.789672544,167,334,5.566666667,0.9,297
sub-7031_ses-f1,69,192,0.359375,123,246,4.1,0.9,298
sub-7031_ses-f2,161,374,0.430481283,213,426,7.1,0.9,299
sub-7031_ses-f3,686,737,0.930800543,51,102,1.7,0.9,300
sub-7032_ses-f1,718,720,0.997222222,2,4,0.066666667,0.9,301
sub-7032_ses-f2,66,73,0.904109589,7,14,0.233333333,0.9,302
sub-7032_ses-f3,719,740,0.971621622,21,42,0.7,0.9,303
sub-7033_ses-f2,509,752,0.676861702,243,486,8.1,0.9,304
sub-7034_ses-f1,740,760,0.973684211,20,40,0.666666667,0.9,305
sub-7034_ses-f2,825,912,0.904605263,87,174,2.9,0.9,306
sub-7034_ses-f3,410,728,0.563186813,318,636,10.6,0.9,307
sub-7035_ses-f1,37,50,0.74,13,26,0.433333333,0.9,308
sub-7035_ses-f2,579,727,0.796423659,148,296,4.933333333,0.9,309
sub-7036_ses-f1,658,745,0.883221477,87,174,2.9,0.9,310
sub-7037_ses-f1,769,772,0.99611399,3,6,0.1,0.9,311
sub-7037_ses-f2,842,852,0.988262911,10,20,0.333333333,0.9,312
sub-7037_ses-f3,688,720,0.955555556,32,64,1.066666667,0.9,313
sub-7038_ses-f1,719,789,0.911280101,70,140,2.333333333,0.9,314
sub-7038_ses-f2,509,785,0.648407643,276,552,9.2,0.9,315
sub-7039_ses-f1,707,785,0.900636943,78,156,2.6,0.9,316
sub-7039_ses-f2,620,727,0.852819807,107,214,3.566666667,0.9,317
sub-7040_ses-f1,607,728,0.833791209,121,242,4.033333333,0.9,318
sub-7040_ses-f2,571,720,0.793055556,149,298,4.966666667,0.9,319
sub-7040_ses-f3,521,720,0.723611111,199,398,6.633333333,0.9,320
sub-7041_ses-f1,745,754,0.98806366,9,18,0.3,0.9,321
sub-7041_ses-f2,581,735,0.79047619,154,308,5.133333333,0.9,322
sub-7042_ses-f3,539,658,0.819148936,119,238,3.966666667,0.9,323
sub-7043_ses-f2,898,1080,0.831481481,182,364,6.066666667,0.9,324
sub-7044_ses-f2,685,739,0.926928281,54,108,1.8,0.9,325
sub-7045_ses-f1,783,823,0.951397327,40,80,1.333333333,0.9,326
sub-7046_ses-f1,786,812,0.967980296,26,52,0.866666667,0.9,327
sub-7046_ses-f2,38,61,0.62295082,23,46,0.766666667,0.9,328
sub-7046_ses-f3,648,741,0.874493927,93,186,3.1,0.9,329
sub-7047_ses-f1,717,720,0.995833333,3,6,0.1,0.9,330
sub-7047_ses-f2,40,64,0.625,24,48,0.8,0.9,331
sub-7048_ses-f1,5,6,0.833333333,1,2,0.033333333,0.9,332
sub-7048_ses-f2,318,360,0.883333333,42,84,1.4,0.9,333
sub-7049_ses-f1,305,360,0.847222222,55,110,1.833333333,0.9,334
sub-7052_ses-f1,470,518,0.907335907,48,96,1.6,0.9,335
sub-7053_ses-f1,692,720,0.961111111,28,56,0.933333333,0.9,336
sub-7054_ses-f1,701,766,0.915143603,65,130,2.166666667,0.9,337
sub-2006_ses-T1,325,420,0.773809524,95,190,3.166666667,1,1
sub-2011_ses-T1,308,360,0.855555556,52,104,1.733333333,1,2
sub-2012_ses-T1,179,180,0.994444444,1,2,0.033333333,1,3
sub-2013_ses-T1,296,360,0.822222222,64,128,2.133333333,1,4
sub-2014_ses-T1,345,360,0.958333333,15,30,0.5,1,5
sub-2015_ses-T1,71,180,0.394444444,109,218,3.633333333,1,6
sub-2016_ses-T1,344,360,0.955555556,16,32,0.533333333,1,7
sub-2017_ses-T1,179,180,0.994444444,1,2,0.033333333,1,8
sub-2018_ses-T1,161,180,0.894444444,19,38,0.633333333,1,9
sub-2019_ses-T1,343,360,0.952777778,17,34,0.566666667,1,10
sub-2020_ses-T1,19,26,0.730769231,7,14,0.233333333,1,11
sub-2020_ses-T2,293,360,0.813888889,67,134,2.233333333,1,12
sub-2021_ses-T1,320,360,0.888888889,40,80,1.333333333,1,13
sub-2022_ses-T1,304,360,0.844444444,56,112,1.866666667,1,14
sub-2023_ses-T1,194,360,0.538888889,166,332,5.533333333,1,15
sub-2024_ses-T2,11,12,0.916666667,1,2,0.033333333,1,16
sub-2026_ses-T1,204,223,0.914798206,19,38,0.633333333,1,17
sub-2027_ses-T1,357,360,0.991666667,3,6,0.1,1,18
sub-2028_ses-T1,287,360,0.797222222,73,146,2.433333333,1,19
sub-2029_ses-T1,334,360,0.927777778,26,52,0.866666667,1,20
sub-2030_ses-T1,251,360,0.697222222,109,218,3.633333333,1,21
sub-2031_ses-T1,356,360,0.988888889,4,8,0.133333333,1,22
sub-2032_ses-T1,236,360,0.655555556,124,248,4.133333333,1,23
sub-2033_ses-T1,353,360,0.980555556,7,14,0.233333333,1,24
sub-2033_ses-T2,202,360,0.561111111,158,316,5.266666667,1,25
sub-2034_ses-T1,87,180,0.483333333,93,186,3.1,1,26
sub-2035_ses-T1,357,360,0.991666667,3,6,0.1,1,27
sub-2036_ses-T1,352,360,0.977777778,8,16,0.266666667,1,28
sub-2037_ses-T1,338,360,0.938888889,22,44,0.733333333,1,29
sub-2038_ses-T1,357,360,0.991666667,3,6,0.1,1,30
sub-2039_ses-T1,179,180,0.994444444,1,2,0.033333333,1,31
sub-2040_ses-T1,347,360,0.963888889,13,26,0.433333333,1,32
sub-2041_ses-T1,351,360,0.975,9,18,0.3,1,33
sub-2042_ses-T1,159,180,0.883333333,21,42,0.7,1,34
sub-2043_ses-T1,184,360,0.511111111,176,352,5.866666667,1,35
sub-2044_ses-T1,281,360,0.780555556,79,158,2.633333333,1,36
sub-2045_ses-T1,127,180,0.705555556,53,106,1.766666667,1,37
sub-2046_ses-T1,169,180,0.938888889,11,22,0.366666667,1,38
sub-2047_ses-T1,155,180,0.861111111,25,50,0.833333333,1,39
sub-2048_ses-T1,175,180,0.972222222,5,10,0.166666667,1,40
sub-2049_ses-T1,344,360,0.955555556,16,32,0.533333333,1,41
sub-2051_ses-T1,357,360,0.991666667,3,6,0.1,1,42
sub-2051_ses-T2,357,360,0.991666667,3,6,0.1,1,43
sub-2052_ses-T1,308,360,0.855555556,52,104,1.733333333,1,44
sub-2052_ses-T2,111,180,0.616666667,69,138,2.3,1,45
sub-2053_ses-T1,234,360,0.65,126,252,4.2,1,46
sub-2055_ses-T1,108,180,0.6,72,144,2.4,1,47
sub-2056_ses-T1,358,360,0.994444444,2,4,0.066666667,1,48
sub-2057_ses-T1,356,360,0.988888889,4,8,0.133333333,1,49
sub-2058_ses-T1,281,360,0.780555556,79,158,2.633333333,1,50
sub-2059_ses-T1,264,360,0.733333333,96,192,3.2,1,51
sub-2061_ses-T1,125,180,0.694444444,55,110,1.833333333,1,52
sub-2062_ses-T1,354,360,0.983333333,6,12,0.2,1,53
sub-2063_ses-T1,315,360,0.875,45,90,1.5,1,54
sub-2064_ses-T1,169,180,0.938888889,11,22,0.366666667,1,55
sub-2065_ses-T1,125,180,0.694444444,55,110,1.833333333,1,56
sub-2066_ses-T1,170,180,0.944444444,10,20,0.333333333,1,57
sub-2066_ses-T2,339,360,0.941666667,21,42,0.7,1,58
sub-2067_ses-T1,347,360,0.963888889,13,26,0.433333333,1,59
sub-2068_ses-T1,344,360,0.955555556,16,32,0.533333333,1,60
sub-2069_ses-T1,315,360,0.875,45,90,1.5,1,61
sub-2070_ses-T1,323,360,0.897222222,37,74,1.233333333,1,62
sub-2071_ses-T1,338,360,0.938888889,22,44,0.733333333,1,63
sub-2072_ses-T1,345,360,0.958333333,15,30,0.5,1,64
sub-2073_ses-T1,252,256,0.984375,4,8,0.133333333,1,65
sub-2073_ses-T2,149,180,0.827777778,31,62,1.033333333,1,66
sub-2074_ses-T1,116,180,0.644444444,64,128,2.133333333,1,67
sub-2075_ses-T1,175,180,0.972222222,5,10,0.166666667,1,68
sub-2076_ses-T1,273,360,0.758333333,87,174,2.9,1,69
sub-2076_ses-T2,173,360,0.480555556,187,374,6.233333333,1,70
sub-2077_ses-T1,357,360,0.991666667,3,6,0.1,1,71
sub-2078_ses-T1,352,360,0.977777778,8,16,0.266666667,1,72
sub-2079_ses-T1,344,360,0.955555556,16,32,0.533333333,1,73
sub-2079_ses-T2,237,360,0.658333333,123,246,4.1,1,74
sub-2080_ses-T1,209,360,0.580555556,151,302,5.033333333,1,75
sub-2081_ses-T1,354,360,0.983333333,6,12,0.2,1,76
sub-2082_ses-T1,308,360,0.855555556,52,104,1.733333333,1,77
sub-2083_ses-T1,217,360,0.602777778,143,286,4.766666667,1,78
sub-2084_ses-T1,357,360,0.991666667,3,6,0.1,1,79
sub-2085_ses-T1,319,360,0.886111111,41,82,1.366666667,1,80
sub-2086_ses-T1,169,360,0.469444444,191,382,6.366666667,1,81
sub-2087_ses-T1,353,360,0.980555556,7,14,0.233333333,1,82
sub-2088_ses-T1,343,360,0.952777778,17,34,0.566666667,1,83
sub-2089_ses-T1,178,180,0.988888889,2,4,0.066666667,1,84
sub-2091_ses-T1,261,360,0.725,99,198,3.3,1,85
sub-2092_ses-T1,328,360,0.911111111,32,64,1.066666667,1,86
sub-2093_ses-T1,344,360,0.955555556,16,32,0.533333333,1,87
sub-2094_ses-T1,173,180,0.961111111,7,14,0.233333333,1,88
sub-2095_ses-T1,356,360,0.988888889,4,8,0.133333333,1,89
sub-2096_ses-T1,336,360,0.933333333,24,48,0.8,1,90
sub-2097_ses-T1,523,540,0.968518519,17,34,0.566666667,1,91
sub-2098_ses-T1,259,360,0.719444444,101,202,3.366666667,1,92
sub-2099_ses-T1,174,180,0.966666667,6,12,0.2,1,93
sub-2099_ses-T2,339,360,0.941666667,21,42,0.7,1,94
sub-2100_ses-T1,162,180,0.9,18,36,0.6,1,95
sub-2100_ses-T2,298,360,0.827777778,62,124,2.066666667,1,96
sub-2101_ses-T1,316,360,0.877777778,44,88,1.466666667,1,97
sub-2101_ses-T2,263,360,0.730555556,97,194,3.233333333,1,98
sub-2102_ses-T1,355,360,0.986111111,5,10,0.166666667,1,99
sub-2103_ses-T1,324,360,0.9,36,72,1.2,1,100
sub-2103_ses-T2,357,360,0.991666667,3,6,0.1,1,101
sub-2104_ses-T1,377,387,0.974160207,10,20,0.333333333,1,102
sub-2105_ses-T1,354,360,0.983333333,6,12,0.2,1,103
sub-2105_ses-T2,355,360,0.986111111,5,10,0.166666667,1,104
sub-2106_ses-T1,357,360,0.991666667,3,6,0.1,1,105
sub-2107_ses-T1,253,360,0.702777778,107,214,3.566666667,1,106
sub-2107_ses-T2,277,360,0.769444444,83,166,2.766666667,1,107
sub-2108_ses-T1,358,360,0.994444444,2,4,0.066666667,1,108
sub-2108_ses-T3,137,141,0.971631206,4,8,0.133333333,1,109
sub-2109_ses-T1,171,180,0.95,9,18,0.3,1,110
sub-2110_ses-T1,266,274,0.97080292,8,16,0.266666667,1,111
sub-2115_ses-T1,352,360,0.977777778,8,16,0.266666667,1,112
sub-2115_ses-T2,342,360,0.95,18,36,0.6,1,113
sub-2117_ses-T1,349,360,0.969444444,11,22,0.366666667,1,114
sub-2117_ses-T2,267,360,0.741666667,93,186,3.1,1,115
sub-2118_ses-T1,301,360,0.836111111,59,118,1.966666667,1,116
sub-2120_ses-T1,345,360,0.958333333,15,30,0.5,1,117
sub-2122_ses-T1,335,360,0.930555556,25,50,0.833333333,1,118
sub-2123_ses-T1,350,360,0.972222222,10,20,0.333333333,1,119
sub-2124_ses-T1,346,404,0.856435644,58,116,1.933333333,1,120
sub-2126_ses-T1,335,360,0.930555556,25,50,0.833333333,1,121
sub-2128_ses-T1,347,360,0.963888889,13,26,0.433333333,1,122
sub-2133_ses-T1,326,360,0.905555556,34,68,1.133333333,1,123
sub-2135_ses-T1,8,19,0.421052632,11,22,0.366666667,1,124
sub-2136_ses-T1,603,720,0.8375,117,234,3.9,1,125
sub-2137_ses-T1,639,720,0.8875,81,162,2.7,1,126
sub-2137_ses-T2,171,360,0.475,189,378,6.3,1,127
sub-2138_ses-T1,356,360,0.988888889,4,8,0.133333333,1,128
sub-2139_ses-T1,244,360,0.677777778,116,232,3.866666667,1,129
sub-2140_ses-T1,377,379,0.994722955,2,4,0.066666667,1,130
sub-2141_ses-T1,284,360,0.788888889,76,152,2.533333333,1,131
sub-2142_ses-T2,358,360,0.994444444,2,4,0.066666667,1,132
sub-2143_ses-T1,311,360,0.863888889,49,98,1.633333333,1,133
sub-2144_ses-T1,324,372,0.870967742,48,96,1.6,1,134
sub-2145_ses-T1,312,360,0.866666667,48,96,1.6,1,135
sub-2145_ses-T2,219,360,0.608333333,141,282,4.7,1,136
sub-2146_ses-T1,355,360,0.986111111,5,10,0.166666667,1,137
sub-2146_ses-T2,622,720,0.863888889,98,196,3.266666667,1,138
sub-2147_ses-T1,328,360,0.911111111,32,64,1.066666667,1,139
sub-2147_ses-T2,343,360,0.952777778,17,34,0.566666667,1,140
sub-2148_ses-T1,390,399,0.977443609,9,18,0.3,1,141
sub-2149_ses-T1,336,360,0.933333333,24,48,0.8,1,142
sub-2150_ses-T1,359,360,0.997222222,1,2,0.033333333,1,143
sub-2150_ses-T2,332,360,0.922222222,28,56,0.933333333,1,144
sub-2151_ses-T1,672,720,0.933333333,48,96,1.6,1,145
sub-2151_ses-T2,686,773,0.887451488,87,174,2.9,1,146
sub-2152_ses-T1,358,360,0.994444444,2,4,0.066666667,1,147
sub-2152_ses-T2,328,360,0.911111111,32,64,1.066666667,1,148
sub-2153_ses-T1,379,383,0.989556136,4,8,0.133333333,1,149
sub-2154_ses-T2,356,360,0.988888889,4,8,0.133333333,1,150
sub-2155_ses-T1,343,360,0.952777778,17,34,0.566666667,1,151
sub-2156_ses-T1,297,360,0.825,63,126,2.1,1,152
sub-2157_ses-T1,351,360,0.975,9,18,0.3,1,153
sub-2158_ses-T1,338,360,0.938888889,22,44,0.733333333,1,154
sub-2159_ses-T1,309,360,0.858333333,51,102,1.7,1,155
sub-2160_ses-T1,310,360,0.861111111,50,100,1.666666667,1,156
sub-2161_ses-T1,341,360,0.947222222,19,38,0.633333333,1,157
sub-2162_ses-T1,348,360,0.966666667,12,24,0.4,1,158
sub-2163_ses-T1,382,399,0.957393484,17,34,0.566666667,1,159
sub-2164_ses-T1,404,720,0.561111111,316,632,10.53333333,1,160
sub-2164_ses-T2,590,720,0.819444444,130,260,4.333333333,1,161
sub-2165_ses-T1,415,481,0.862785863,66,132,2.2,1,162
sub-2166_ses-T1,349,360,0.969444444,11,22,0.366666667,1,163
sub-2166_ses-T2,278,360,0.772222222,82,164,2.733333333,1,164
sub-2167_ses-T1,361,370,0.975675676,9,18,0.3,1,165
sub-2168_ses-T1,354,360,0.983333333,6,12,0.2,1,166
sub-2168_ses-T2,337,360,0.936111111,23,46,0.766666667,1,167
sub-2169_ses-T1,356,360,0.988888889,4,8,0.133333333,1,168
sub-2169_ses-T2,316,360,0.877777778,44,88,1.466666667,1,169
sub-2170_ses-T1,218,264,0.825757576,46,92,1.533333333,1,170
sub-2171_ses-T1,353,374,0.943850267,21,42,0.7,1,171
sub-2171_ses-T2,366,483,0.757763975,117,234,3.9,1,172
sub-2171_ses-T3,398,577,0.689774697,179,358,5.966666667,1,173
sub-2172_ses-T1,426,513,0.830409357,87,174,2.9,1,174
sub-2172_ses-T2,373,386,0.966321244,13,26,0.433333333,1,175
sub-2173_ses-T1,276,360,0.766666667,84,168,2.8,1,176
sub-2174_ses-T1,370,416,0.889423077,46,92,1.533333333,1,177
sub-2175_ses-T1,662,679,0.974963181,17,34,0.566666667,1,178
sub-2176_ses-T1,236,360,0.655555556,124,248,4.133333333,1,179
sub-2176_ses-T2,52,360,0.144444444,308,616,10.26666667,1,180
sub-2177_ses-T1,688,695,0.989928058,7,14,0.233333333,1,181
sub-2177_ses-T2,721,736,0.979619565,15,30,0.5,1,182
sub-2178_ses-T2,300,360,0.833333333,60,120,2,1,183
sub-2179_ses-T2,668,720,0.927777778,52,104,1.733333333,1,184
sub-2180_ses-T1,281,360,0.780555556,79,158,2.633333333,1,185
sub-2180_ses-T2,140,360,0.388888889,220,440,7.333333333,1,186
sub-2181_ses-T1,349,360,0.969444444,11,22,0.366666667,1,187
sub-2182_ses-T1,48,51,0.941176471,3,6,0.1,1,188
sub-2184_ses-T1,371,391,0.948849105,20,40,0.666666667,1,189
sub-2185_ses-T1,352,360,0.977777778,8,16,0.266666667,1,190
sub-2186_ses-T1,295,371,0.795148248,76,152,2.533333333,1,191
sub-2187_ses-T1,45,48,0.9375,3,6,0.1,1,192
sub-2188_ses-T1,435,445,0.97752809,10,20,0.333333333,1,193
sub-2189_ses-T1,196,204,0.960784314,8,16,0.266666667,1,194
sub-2190_ses-T1,311,360,0.863888889,49,98,1.633333333,1,195
sub-2191_ses-T1,357,360,0.991666667,3,6,0.1,1,196
sub-2191_ses-T2,223,360,0.619444444,137,274,4.566666667,1,197
sub-2192_ses-T1,359,360,0.997222222,1,2,0.033333333,1,198
sub-2193_ses-T2,600,625,0.96,25,50,0.833333333,1,199
sub-2194_ses-T1,399,415,0.961445783,16,32,0.533333333,1,200
sub-2195_ses-T1,142,360,0.394444444,218,436,7.266666667,1,201
sub-2196_ses-T1,330,416,0.793269231,86,172,2.866666667,1,202
sub-2197_ses-T1,413,439,0.940774487,26,52,0.866666667,1,203
sub-2197_ses-T2,323,384,0.841145833,61,122,2.033333333,1,204
sub-2198_ses-T1,391,407,0.960687961,16,32,0.533333333,1,205
sub-2199_ses-T1,391,404,0.967821782,13,26,0.433333333,1,206
sub-2200_ses-T1,307,360,0.852777778,53,106,1.766666667,1,207
sub-2201_ses-T1,346,360,0.961111111,14,28,0.466666667,1,208
sub-2202_ses-T1,512,606,0.844884488,94,188,3.133333333,1,209
sub-2203_ses-T1,317,360,0.880555556,43,86,1.433333333,1,210
sub-2204_ses-T1,336,360,0.933333333,24,48,0.8,1,211
sub-2204_ses-T2,348,360,0.966666667,12,24,0.4,1,212
sub-2205_ses-T1,344,360,0.955555556,16,32,0.533333333,1,213
sub-2206_ses-T1,355,360,0.986111111,5,10,0.166666667,1,214
sub-2206_ses-T2,576,720,0.8,144,288,4.8,1,215
sub-2207_ses-T1,258,360,0.716666667,102,204,3.4,1,216
sub-2207_ses-T2,293,360,0.813888889,67,134,2.233333333,1,217
sub-2208_ses-T1,342,360,0.95,18,36,0.6,1,218
sub-2208_ses-T2,306,360,0.85,54,108,1.8,1,219
sub-2209_ses-T1,330,341,0.967741935,11,22,0.366666667,1,220
sub-2210_ses-T1,34,38,0.894736842,4,8,0.133333333,1,221
sub-2211_ses-T1,355,360,0.986111111,5,10,0.166666667,1,222
sub-2212_ses-T1,358,360,0.994444444,2,4,0.066666667,1,223
sub-2213_ses-T1,245,286,0.856643357,41,82,1.366666667,1,224
sub-2214_ses-T1,368,373,0.986595174,5,10,0.166666667,1,225
sub-2215_ses-T1,356,360,0.988888889,4,8,0.133333333,1,226
sub-2216_ses-T1,67,86,0.779069767,19,38,0.633333333,1,227
sub-2216_ses-T2,126,181,0.696132597,55,110,1.833333333,1,228
sub-2217_ses-T1,254,360,0.705555556,106,212,3.533333333,1,229
sub-2217_ses-T2,71,360,0.197222222,289,578,9.633333333,1,230
sub-2218_ses-T1,332,360,0.922222222,28,56,0.933333333,1,231
sub-2218_ses-T2,490,720,0.680555556,230,460,7.666666667,1,232
sub-2219_ses-T1,358,360,0.994444444,2,4,0.066666667,1,233
sub-2220_ses-T1,356,360,0.988888889,4,8,0.133333333,1,234
sub-2220_ses-T2,596,720,0.827777778,124,248,4.133333333,1,235
sub-2221_ses-T1,276,360,0.766666667,84,168,2.8,1,236
sub-2221_ses-T2,624,720,0.866666667,96,192,3.2,1,237
sub-2222_ses-T1,307,360,0.852777778,53,106,1.766666667,1,238
sub-2223_ses-T1,349,360,0.969444444,11,22,0.366666667,1,239
sub-2223_ses-T2,598,720,0.830555556,122,244,4.066666667,1,240
sub-2224_ses-T1,318,379,0.839050132,61,122,2.033333333,1,241
sub-2225_ses-T1,350,360,0.972222222,10,20,0.333333333,1,242
sub-2225_ses-T2,700,759,0.92226614,59,118,1.966666667,1,243
sub-2226_ses-T1,264,365,0.723287671,101,202,3.366666667,1,244
sub-2226_ses-T2,279,360,0.775,81,162,2.7,1,245
sub-2227_ses-T1,351,360,0.975,9,18,0.3,1,246
sub-2228_ses-T1,354,360,0.983333333,6,12,0.2,1,247
sub-2228_ses-T2,660,729,0.905349794,69,138,2.3,1,248
sub-2229_ses-T1,357,360,0.991666667,3,6,0.1,1,249
sub-2229_ses-T2,332,390,0.851282051,58,116,1.933333333,1,250
sub-2230_ses-T1,388,398,0.974874372,10,20,0.333333333,1,251
sub-7001_ses-f2,433,720,0.601388889,287,574,9.566666667,1,252
sub-7001_ses-f3,191,720,0.265277778,529,1058,17.63333333,1,253
sub-7002_ses-f1,631,720,0.876388889,89,178,2.966666667,1,254
sub-7002_ses-f2,554,720,0.769444444,166,332,5.533333333,1,255
sub-7003_ses-f1,329,360,0.913888889,31,62,1.033333333,1,256
sub-7003_ses-f2,35,180,0.194444444,145,290,4.833333333,1,257
sub-7004_ses-f3,513,724,0.708563536,211,422,7.033333333,1,258
sub-7006_ses-f1,48,52,0.923076923,4,8,0.133333333,1,259
sub-7008_ses-f1,678,720,0.941666667,42,84,1.4,1,260
sub-7008_ses-f2,286,720,0.397222222,434,868,14.46666667,1,261
sub-7009_ses-f1,602,720,0.836111111,118,236,3.933333333,1,262
sub-7009_ses-f2,372,720,0.516666667,348,696,11.6,1,263
sub-7011_ses-f1,912,917,0.994547437,5,10,0.166666667,1,264
sub-7011_ses-f2,317,360,0.880555556,43,86,1.433333333,1,265
sub-7012_ses-f1,743,761,0.976346912,18,36,0.6,1,266
sub-7012_ses-f2,649,720,0.901388889,71,142,2.366666667,1,267
sub-7014_ses-f1,330,360,0.916666667,30,60,1,1,268
sub-7014_ses-f2,684,720,0.95,36,72,1.2,1,269
sub-7015_ses-f1,777,832,0.933894231,55,110,1.833333333,1,270
sub-7015_ses-f2,618,729,0.847736626,111,222,3.7,1,271
sub-7016_ses-f1,690,750,0.92,60,120,2,1,272
sub-7016_ses-f2,258,720,0.358333333,462,924,15.4,1,273
sub-7017_ses-f1,736,740,0.994594595,4,8,0.133333333,1,274
sub-7017_ses-f2,698,725,0.962758621,27,54,0.9,1,275
sub-7020_ses-f1,654,740,0.883783784,86,172,2.866666667,1,276
sub-7020_ses-f2,449,720,0.623611111,271,542,9.033333333,1,277
sub-7021_ses-f1,747,753,0.992031873,6,12,0.2,1,278
sub-7022_ses-f1,715,720,0.993055556,5,10,0.166666667,1,279
sub-7022_ses-f2,716,727,0.984869326,11,22,0.366666667,1,280
sub-7023_ses-f1,701,744,0.942204301,43,86,1.433333333,1,281
sub-7023_ses-f2,773,829,0.932448733,56,112,1.866666667,1,282
sub-7024_ses-f1,717,728,0.98489011,11,22,0.366666667,1,283
sub-7025_ses-f1,675,729,0.925925926,54,108,1.8,1,284
sub-7025_ses-f2,486,760,0.639473684,274,548,9.133333333,1,285
sub-7026_ses-f1,855,920,0.929347826,65,130,2.166666667,1,286
sub-7026_ses-f2,876,914,0.958424508,38,76,1.266666667,1,287
sub-7026_ses-f3,341,731,0.466484268,390,780,13,1,288
sub-7027_ses-f1,880,885,0.994350282,5,10,0.166666667,1,289
sub-7027_ses-f2,315,410,0.768292683,95,190,3.166666667,1,290
sub-7027_ses-f3,555,725,0.765517241,170,340,5.666666667,1,291
sub-7028_ses-f1,749,752,0.996010638,3,6,0.1,1,292
sub-7028_ses-f2,710,720,0.986111111,10,20,0.333333333,1,293
sub-7029_ses-f1,674,731,0.922024624,57,114,1.9,1,294
sub-7029_ses-f2,593,725,0.817931034,132,264,4.4,1,295
sub-7030_ses-f1,621,720,0.8625,99,198,3.3,1,296
sub-7030_ses-f2,595,794,0.749370277,199,398,6.633333333,1,297
sub-7031_ses-f1,59,192,0.307291667,133,266,4.433333333,1,298
sub-7031_ses-f2,135,374,0.360962567,239,478,7.966666667,1,299
sub-7031_ses-f3,672,737,0.911804613,65,130,2.166666667,1,300
sub-7032_ses-f1,717,720,0.995833333,3,6,0.1,1,301
sub-7032_ses-f2,66,73,0.904109589,7,14,0.233333333,1,302
sub-7032_ses-f3,706,740,0.954054054,34,68,1.133333333,1,303
sub-7033_ses-f2,482,752,0.640957447,270,540,9,1,304
sub-7034_ses-f1,734,760,0.965789474,26,52,0.866666667,1,305
sub-7034_ses-f2,809,912,0.887061404,103,206,3.433333333,1,306
sub-7034_ses-f3,362,728,0.497252747,366,732,12.2,1,307
sub-7035_ses-f1,33,50,0.66,17,34,0.566666667,1,308
sub-7035_ses-f2,533,727,0.733149931,194,388,6.466666667,1,309
sub-7036_ses-f1,639,745,0.857718121,106,212,3.533333333,1,310
sub-7037_ses-f1,768,772,0.994818653,4,8,0.133333333,1,311
sub-7037_ses-f2,839,852,0.984741784,13,26,0.433333333,1,312
sub-7037_ses-f3,675,720,0.9375,45,90,1.5,1,313
sub-7038_ses-f1,708,789,0.897338403,81,162,2.7,1,314
sub-7038_ses-f2,473,785,0.602547771,312,624,10.4,1,315
sub-7039_ses-f1,694,785,0.884076433,91,182,3.033333333,1,316
sub-7039_ses-f2,595,727,0.818431912,132,264,4.4,1,317
sub-7040_ses-f1,588,728,0.807692308,140,280,4.666666667,1,318
sub-7040_ses-f2,541,720,0.751388889,179,358,5.966666667,1,319
sub-7040_ses-f3,495,720,0.6875,225,450,7.5,1,320
sub-7041_ses-f1,743,754,0.985411141,11,22,0.366666667,1,321
sub-7041_ses-f2,532,735,0.723809524,203,406,6.766666667,1,322
sub-7042_ses-f3,512,658,0.778115502,146,292,4.866666667,1,323
sub-7043_ses-f2,835,1080,0.773148148,245,490,8.166666667,1,324
sub-7044_ses-f2,678,739,0.917456022,61,122,2.033333333,1,325
sub-7045_ses-f1,779,823,0.94653706,44,88,1.466666667,1,326
sub-7046_ses-f1,771,812,0.949507389,41,82,1.366666667,1,327
sub-7046_ses-f2,38,61,0.62295082,23,46,0.766666667,1,328
sub-7046_ses-f3,611,741,0.824561404,130,260,4.333333333,1,329
sub-7047_ses-f1,717,720,0.995833333,3,6,0.1,1,330
sub-7047_ses-f2,40,64,0.625,24,48,0.8,1,331
sub-7048_ses-f1,5,6,0.833333333,1,2,0.033333333,1,332
sub-7048_ses-f2,315,360,0.875,45,90,1.5,1,333
sub-7049_ses-f1,289,360,0.802777778,71,142,2.366666667,1,334
sub-7052_ses-f1,453,518,0.874517375,65,130,2.166666667,1,335
sub-7053_ses-f1,674,720,0.936111111,46,92,1.533333333,1,336
sub-7054_ses-f1,694,766,0.906005222,72,144,2.4,1,337
sub-2006_ses-T1,211,420,0.5024,209,418,6.966666667,2,1
sub-2011_ses-T1,175,360,0.4861,185,370,6.166666667,2,2
sub-2012_ses-T1,179,180,0.9944,1,2,0.033333333,2,3
sub-2013_ses-T1,211,360,0.5861,149,298,4.966666667,2,4
sub-2014_ses-T1,256,360,0.7111,104,208,3.466666667,2,5
sub-2015_ses-T1,27,180,0.15,153,306,5.1,2,6
sub-2016_ses-T1,254,360,0.7056,106,212,3.533333333,2,7
sub-2017_ses-T1,169,180,0.9389,11,22,0.366666667,2,8
sub-2018_ses-T1,97,180,0.5389,83,166,2.766666667,2,9
sub-2019_ses-T1,290,360,0.8056,70,140,2.333333333,2,10
sub-2020_ses-T1,17,26,0.6538,9,18,0.3,2,11
sub-2020_ses-T2,182,360,0.5056,178,356,5.933333333,2,12
sub-2021_ses-T1,200,360,0.5556,160,320,5.333333333,2,13
sub-2022_ses-T1,200,360,0.5556,160,320,5.333333333,2,14
sub-2023_ses-T1,130,360,0.3611,230,460,7.666666667,2,15
sub-2024_ses-T2,8,12,0.6667,4,8,0.133333333,2,16
sub-2026_ses-T1,146,223,0.6547,77,154,2.566666667,2,17
sub-2027_ses-T1,332,360,0.9222,28,56,0.933333333,2,18
sub-2028_ses-T1,188,360,0.5222,172,344,5.733333333,2,19
sub-2029_ses-T1,252,360,0.7,108,216,3.6,2,20
sub-2030_ses-T1,102,360,0.2833,258,516,8.6,2,21
sub-2031_ses-T1,351,360,0.975,9,18,0.3,2,22
sub-2032_ses-T1,107,360,0.2972,253,506,8.433333333,2,23
sub-2033_ses-T1,331,360,0.9194,29,58,0.966666667,2,24
sub-2033_ses-T2,126,360,0.35,234,468,7.8,2,25
sub-2034_ses-T1,15,180,0.0833,165,330,5.5,2,26
sub-2035_ses-T1,331,360,0.9194,29,58,0.966666667,2,27
sub-2036_ses-T1,295,360,0.8194,65,130,2.166666667,2,28
sub-2037_ses-T1,257,360,0.7139,103,206,3.433333333,2,29
sub-2038_ses-T1,345,360,0.9583,15,30,0.5,2,30
sub-2039_ses-T1,179,180,0.9944,1,2,0.033333333,2,31
sub-2040_ses-T1,297,360,0.825,63,126,2.1,2,32
sub-2041_ses-T1,312,360,0.8667,48,96,1.6,2,33
sub-2042_ses-T1,72,180,0.4,108,216,3.6,2,34
sub-2043_ses-T1,102,360,0.2833,258,516,8.6,2,35
sub-2044_ses-T1,162,360,0.45,198,396,6.6,2,36
sub-2045_ses-T1,47,180,0.2611,133,266,4.433333333,2,37
sub-2046_ses-T1,142,180,0.7889,38,76,1.266666667,2,38
sub-2047_ses-T1,81,180,0.45,99,198,3.3,2,39
sub-2048_ses-T1,159,180,0.8833,21,42,0.7,2,40
sub-2049_ses-T1,280,360,0.7778,80,160,2.666666667,2,41
sub-2051_ses-T1,350,360,0.9722,10,20,0.333333333,2,42
sub-2051_ses-T2,345,360,0.9583,15,30,0.5,2,43
sub-2052_ses-T1,222,360,0.6167,138,276,4.6,2,44
sub-2052_ses-T2,54,180,0.3,126,252,4.2,2,45
sub-2053_ses-T1,143,360,0.3972,217,434,7.233333333,2,46
sub-2055_ses-T1,55,180,0.3056,125,250,4.166666667,2,47
sub-2056_ses-T1,352,360,0.9778,8,16,0.266666667,2,48
sub-2057_ses-T1,304,360,0.8444,56,112,1.866666667,2,49
sub-2058_ses-T1,236,360,0.6556,124,248,4.133333333,2,50
sub-2059_ses-T1,226,360,0.6278,134,268,4.466666667,2,51
sub-2061_ses-T1,68,180,0.3778,112,224,3.733333333,2,52
sub-2062_ses-T1,328,360,0.9111,32,64,1.066666667,2,53
sub-2063_ses-T1,197,360,0.5472,163,326,5.433333333,2,54
sub-2064_ses-T1,133,180,0.7389,47,94,1.566666667,2,55
sub-2065_ses-T1,55,180,0.3056,125,250,4.166666667,2,56
sub-2066_ses-T1,140,180,0.7778,40,80,1.333333333,2,57
sub-2066_ses-T2,254,360,0.7056,106,212,3.533333333,2,58
sub-2067_ses-T1,267,360,0.7417,93,186,3.1,2,59
sub-2068_ses-T1,295,360,0.8194,65,130,2.166666667,2,60
sub-2069_ses-T1,162,360,0.45,198,396,6.6,2,61
sub-2070_ses-T1,265,360,0.7361,95,190,3.166666667,2,62
sub-2071_ses-T1,277,360,0.7694,83,166,2.766666667,2,63
sub-2072_ses-T1,300,360,0.8333,60,120,2,2,64
sub-2073_ses-T1,243,256,0.9492,13,26,0.433333333,2,65
sub-2073_ses-T2,104,180,0.5778,76,152,2.533333333,2,66
sub-2074_ses-T1,38,180,0.2111,142,284,4.733333333,2,67
sub-2075_ses-T1,151,180,0.8389,29,58,0.966666667,2,68
sub-2076_ses-T1,156,360,0.4333,204,408,6.8,2,69
sub-2076_ses-T2,60,360,0.1667,300,600,10,2,70
sub-2077_ses-T1,331,360,0.9194,29,58,0.966666667,2,71
sub-2078_ses-T1,311,360,0.8639,49,98,1.633333333,2,72
sub-2079_ses-T1,270,360,0.75,90,180,3,2,73
sub-2079_ses-T2,122,360,0.3389,238,476,7.933333333,2,74
sub-2080_ses-T1,127,360,0.3528,233,466,7.766666667,2,75
sub-2081_ses-T1,309,360,0.8583,51,102,1.7,2,76
sub-2082_ses-T1,187,360,0.5194,173,346,5.766666667,2,77
sub-2083_ses-T1,109,360,0.3028,251,502,8.366666667,2,78
sub-2084_ses-T1,353,360,0.9806,7,14,0.233333333,2,79
sub-2085_ses-T1,224,360,0.6222,136,272,4.533333333,2,80
sub-2086_ses-T1,72,360,0.2,288,576,9.6,2,81
sub-2087_ses-T1,339,360,0.9417,21,42,0.7,2,82
sub-2088_ses-T1,288,360,0.8,72,144,2.4,2,83
sub-2089_ses-T1,170,180,0.9444,10,20,0.333333333,2,84
sub-2091_ses-T1,136,360,0.3778,224,448,7.466666667,2,85
sub-2092_ses-T1,270,360,0.75,90,180,3,2,86
sub-2093_ses-T1,280,360,0.7778,80,160,2.666666667,2,87
sub-2094_ses-T1,172,180,0.9556,8,16,0.266666667,2,88
sub-2095_ses-T1,312,360,0.8667,48,96,1.6,2,89
sub-2096_ses-T1,260,360,0.7222,100,200,3.333333333,2,90
sub-2097_ses-T1,458,540,0.8481,82,164,2.733333333,2,91
sub-2098_ses-T1,111,360,0.3083,249,498,8.3,2,92
sub-2099_ses-T1,127,180,0.7056,53,106,1.766666667,2,93
sub-2099_ses-T2,193,360,0.5361,167,334,5.566666667,2,94
sub-2100_ses-T1,127,180,0.7056,53,106,1.766666667,2,95
sub-2100_ses-T2,161,360,0.4472,199,398,6.633333333,2,96
sub-2101_ses-T1,245,360,0.6806,115,230,3.833333333,2,97
sub-2101_ses-T2,150,360,0.4167,210,420,7,2,98
sub-2102_ses-T1,313,360,0.8694,47,94,1.566666667,2,99
sub-2103_ses-T1,233,360,0.6472,127,254,4.233333333,2,100
sub-2103_ses-T2,322,360,0.8944,38,76,1.266666667,2,101
sub-2104_ses-T1,339,387,0.876,48,96,1.6,2,102
sub-2105_ses-T1,304,360,0.8444,56,112,1.866666667,2,103
sub-2105_ses-T2,311,360,0.8639,49,98,1.633333333,2,104
sub-2106_ses-T1,317,360,0.8806,43,86,1.433333333,2,105
sub-2107_ses-T1,159,360,0.4417,201,402,6.7,2,106
sub-2107_ses-T2,194,360,0.5389,166,332,5.533333333,2,107
sub-2108_ses-T1,352,360,0.9778,8,16,0.266666667,2,108
sub-2108_ses-T3,125,141,0.8865,16,32,0.533333333,2,109
sub-2109_ses-T1,125,180,0.6944,55,110,1.833333333,2,110
sub-2110_ses-T1,248,274,0.9051,26,52,0.866666667,2,111
sub-2115_ses-T1,291,360,0.8083,69,138,2.3,2,112
sub-2115_ses-T2,221,360,0.6139,139,278,4.633333333,2,113
sub-2117_ses-T1,289,360,0.8028,71,142,2.366666667,2,114
sub-2117_ses-T2,127,360,0.3528,233,466,7.766666667,2,115
sub-2118_ses-T1,203,360,0.5639,157,314,5.233333333,2,116
sub-2120_ses-T1,263,360,0.7306,97,194,3.233333333,2,117
sub-2122_ses-T1,269,360,0.7472,91,182,3.033333333,2,118
sub-2123_ses-T1,334,360,0.9278,26,52,0.866666667,2,119
sub-2124_ses-T1,343,404,0.849,61,122,2.033333333,2,120
sub-2126_ses-T1,268,360,0.7444,92,184,3.066666667,2,121
sub-2128_ses-T1,297,360,0.825,63,126,2.1,2,122
sub-2133_ses-T1,223,360,0.6194,137,274,4.566666667,2,123
sub-2135_ses-T1,7,19,0.3684,12,24,0.4,2,124
sub-2136_ses-T1,433,720,0.6014,287,574,9.566666667,2,125
sub-2137_ses-T1,438,720,0.6083,282,564,9.4,2,126
sub-2137_ses-T2,117,360,0.325,243,486,8.1,2,127
sub-2138_ses-T1,327,360,0.9083,33,66,1.1,2,128
sub-2139_ses-T1,116,360,0.3222,244,488,8.133333333,2,129
sub-2140_ses-T1,377,379,0.9947,2,4,0.066666667,2,130
sub-2141_ses-T1,182,360,0.5056,178,356,5.933333333,2,131
sub-2142_ses-T2,334,360,0.9278,26,52,0.866666667,2,132
sub-2143_ses-T1,224,360,0.6222,136,272,4.533333333,2,133
sub-2144_ses-T1,250,372,0.672,122,244,4.066666667,2,134
sub-2145_ses-T1,243,360,0.675,117,234,3.9,2,135
sub-2145_ses-T2,72,360,0.2,288,576,9.6,2,136
sub-2146_ses-T1,331,360,0.9194,29,58,0.966666667,2,137
sub-2146_ses-T2,400,720,0.5556,320,640,10.66666667,2,138
sub-2147_ses-T1,247,360,0.6861,113,226,3.766666667,2,139
sub-2147_ses-T2,276,360,0.7667,84,168,2.8,2,140
sub-2148_ses-T1,359,399,0.8997,40,80,1.333333333,2,141
sub-2149_ses-T1,266,360,0.7389,94,188,3.133333333,2,142
sub-2150_ses-T1,338,360,0.9389,22,44,0.733333333,2,143
sub-2150_ses-T2,236,360,0.6556,124,248,4.133333333,2,144
sub-2151_ses-T1,462,720,0.6417,258,516,8.6,2,145
sub-2151_ses-T2,472,773,0.6106,301,602,10.03333333,2,146
sub-2152_ses-T1,348,360,0.9667,12,24,0.4,2,147
sub-2152_ses-T2,198,360,0.55,162,324,5.4,2,148
sub-2153_ses-T1,357,383,0.9321,26,52,0.866666667,2,149
sub-2154_ses-T2,324,360,0.9,36,72,1.2,2,150
sub-2155_ses-T1,268,360,0.7444,92,184,3.066666667,2,151
sub-2156_ses-T1,194,360,0.5389,166,332,5.533333333,2,152
sub-2157_ses-T1,319,360,0.8861,41,82,1.366666667,2,153
sub-2158_ses-T1,266,360,0.7389,94,188,3.133333333,2,154
sub-2159_ses-T1,208,360,0.5778,152,304,5.066666667,2,155
sub-2160_ses-T1,178,360,0.4944,182,364,6.066666667,2,156
sub-2161_ses-T1,261,360,0.725,99,198,3.3,2,157
sub-2162_ses-T1,302,360,0.8389,58,116,1.933333333,2,158
sub-2163_ses-T1,337,399,0.8446,62,124,2.066666667,2,159
sub-2164_ses-T1,208,720,0.2889,512,1024,17.06666667,2,160
sub-2164_ses-T2,463,720,0.6431,257,514,8.566666667,2,161
sub-2165_ses-T1,279,481,0.58,202,404,6.733333333,2,162
sub-2166_ses-T1,281,360,0.7806,79,158,2.633333333,2,163
sub-2166_ses-T2,191,360,0.5306,169,338,5.633333333,2,164
sub-2167_ses-T1,330,370,0.8919,40,80,1.333333333,2,165
sub-2168_ses-T1,314,360,0.8722,46,92,1.533333333,2,166
sub-2168_ses-T2,270,360,0.75,90,180,3,2,167
sub-2169_ses-T1,326,360,0.9056,34,68,1.133333333,2,168
sub-2169_ses-T2,201,360,0.5583,159,318,5.3,2,169
sub-2170_ses-T1,160,264,0.6061,104,208,3.466666667,2,170
sub-2171_ses-T1,311,374,0.8316,63,126,2.1,2,171
sub-2171_ses-T2,263,483,0.5445,220,440,7.333333333,2,172
sub-2171_ses-T3,219,577,0.3795,358,716,11.93333333,2,173
sub-2172_ses-T1,299,513,0.5828,214,428,7.133333333,2,174
sub-2172_ses-T2,330,386,0.8549,56,112,1.866666667,2,175
sub-2173_ses-T1,153,360,0.425,207,414,6.9,2,176
sub-2174_ses-T1,257,416,0.6178,159,318,5.3,2,177
sub-2175_ses-T1,600,679,0.8837,79,158,2.633333333,2,178
sub-2176_ses-T1,147,360,0.4083,213,426,7.1,2,179
sub-2176_ses-T2,0,360,0,360,720,12,2,180
sub-2177_ses-T1,668,695,0.9612,27,54,0.9,2,181
sub-2177_ses-T2,597,736,0.8111,139,278,4.633333333,2,182
sub-2178_ses-T2,192,360,0.5333,168,336,5.6,2,183
sub-2179_ses-T2,496,720,0.6889,224,448,7.466666667,2,184
sub-2180_ses-T1,180,360,0.5,180,360,6,2,185
sub-2180_ses-T2,66,360,0.1833,294,588,9.8,2,186
sub-2181_ses-T1,317,360,0.8806,43,86,1.433333333,2,187
sub-2182_ses-T1,42,51,0.8235,9,18,0.3,2,188
sub-2184_ses-T1,319,391,0.8159,72,144,2.4,2,189
sub-2185_ses-T1,295,360,0.8194,65,130,2.166666667,2,190
sub-2186_ses-T1,152,371,0.4097,219,438,7.3,2,191
sub-2187_ses-T1,43,48,0.8958,5,10,0.166666667,2,192
sub-2188_ses-T1,413,445,0.9281,32,64,1.066666667,2,193
sub-2189_ses-T1,181,204,0.8873,23,46,0.766666667,2,194
sub-2190_ses-T1,211,360,0.5861,149,298,4.966666667,2,195
sub-2191_ses-T1,327,360,0.9083,33,66,1.1,2,196
sub-2191_ses-T2,24,360,0.0667,336,672,11.2,2,197
sub-2192_ses-T1,323,360,0.8972,37,74,1.233333333,2,198
sub-2193_ses-T2,520,625,0.832,105,210,3.5,2,199
sub-2194_ses-T1,342,415,0.8241,73,146,2.433333333,2,200
sub-2195_ses-T1,83,360,0.2306,277,554,9.233333333,2,201
sub-2196_ses-T1,171,416,0.4111,245,490,8.166666667,2,202
sub-2197_ses-T1,357,439,0.8132,82,164,2.733333333,2,203
sub-2197_ses-T2,191,384,0.4974,193,386,6.433333333,2,204
sub-2198_ses-T1,320,407,0.7862,87,174,2.9,2,205
sub-2199_ses-T1,321,404,0.7946,83,166,2.766666667,2,206
sub-2200_ses-T1,158,360,0.4389,202,404,6.733333333,2,207
sub-2201_ses-T1,305,360,0.8472,55,110,1.833333333,2,208
sub-2202_ses-T1,278,606,0.4587,328,656,10.93333333,2,209
sub-2203_ses-T1,239,360,0.6639,121,242,4.033333333,2,210
sub-2204_ses-T1,286,360,0.7944,74,148,2.466666667,2,211
sub-2204_ses-T2,298,360,0.8278,62,124,2.066666667,2,212
sub-2205_ses-T1,248,360,0.6889,112,224,3.733333333,2,213
sub-2206_ses-T1,332,360,0.9222,28,56,0.933333333,2,214
sub-2206_ses-T2,334,720,0.4639,386,772,12.86666667,2,215
sub-2207_ses-T1,120,360,0.3333,240,480,8,2,216
sub-2207_ses-T2,155,360,0.4306,205,410,6.833333333,2,217
sub-2208_ses-T1,302,360,0.8389,58,116,1.933333333,2,218
sub-2208_ses-T2,202,360,0.5611,158,316,5.266666667,2,219
sub-2209_ses-T1,283,341,0.8299,58,116,1.933333333,2,220
sub-2210_ses-T1,30,38,0.7895,8,16,0.266666667,2,221
sub-2211_ses-T1,310,360,0.8611,50,100,1.666666667,2,222
sub-2212_ses-T1,328,360,0.9111,32,64,1.066666667,2,223
sub-2213_ses-T1,162,286,0.5664,124,248,4.133333333,2,224
sub-2214_ses-T1,349,373,0.9357,24,48,0.8,2,225
sub-2215_ses-T1,327,360,0.9083,33,66,1.1,2,226
sub-2216_ses-T1,36,86,0.4186,50,100,1.666666667,2,227
sub-2216_ses-T2,88,181,0.4862,93,186,3.1,2,228
sub-2217_ses-T1,127,360,0.3528,233,466,7.766666667,2,229
sub-2217_ses-T2,24,360,0.0667,336,672,11.2,2,230
sub-2218_ses-T1,231,360,0.6417,129,258,4.3,2,231
sub-2218_ses-T2,236,720,0.3278,484,968,16.13333333,2,232
sub-2219_ses-T1,343,360,0.9528,17,34,0.566666667,2,233
sub-2220_ses-T1,327,360,0.9083,33,66,1.1,2,234
sub-2220_ses-T2,312,720,0.4333,408,816,13.6,2,235
sub-2221_ses-T1,154,360,0.4278,206,412,6.866666667,2,236
sub-2221_ses-T2,428,720,0.5944,292,584,9.733333333,2,237
sub-2222_ses-T1,189,360,0.525,171,342,5.7,2,238
sub-2223_ses-T1,285,360,0.7917,75,150,2.5,2,239
sub-2223_ses-T2,404,720,0.5611,316,632,10.53333333,2,240
sub-2224_ses-T1,214,379,0.5646,165,330,5.5,2,241
sub-2225_ses-T1,308,360,0.8556,52,104,1.733333333,2,242
sub-2225_ses-T2,453,759,0.5968,306,612,10.2,2,243
sub-2226_ses-T1,141,365,0.3863,224,448,7.466666667,2,244
sub-2226_ses-T2,106,360,0.2944,254,508,8.466666667,2,245
sub-2227_ses-T1,292,360,0.8111,68,136,2.266666667,2,246
sub-2228_ses-T1,319,360,0.8861,41,82,1.366666667,2,247
sub-2228_ses-T2,459,729,0.6296,270,540,9,2,248
sub-2229_ses-T1,335,360,0.9306,25,50,0.833333333,2,249
sub-2229_ses-T2,164,390,0.4205,226,452,7.533333333,2,250
sub-2230_ses-T1,365,398,0.9171,33,66,1.1,2,251
sub-7001_ses-f2,251,720,0.3486,469,938,15.63333333,2,252
sub-7001_ses-f3,85,720,0.1181,635,1270,21.16666667,2,253
sub-7002_ses-f1,385,720,0.5347,335,670,11.16666667,2,254
sub-7002_ses-f2,341,720,0.4736,379,758,12.63333333,2,255
sub-7003_ses-f1,214,360,0.5944,146,292,4.866666667,2,256
sub-7003_ses-f2,6,180,0.0333,174,348,5.8,2,257
sub-7004_ses-f3,345,724,0.4765,379,758,12.63333333,2,258
sub-7006_ses-f1,46,52,0.8846,6,12,0.2,2,259
sub-7008_ses-f1,543,720,0.7542,177,354,5.9,2,260
sub-7008_ses-f2,147,720,0.2042,573,1146,19.1,2,261
sub-7009_ses-f1,407,720,0.5653,313,626,10.43333333,2,262
sub-7009_ses-f2,206,720,0.2861,514,1028,17.13333333,2,263
sub-7011_ses-f1,898,917,0.9793,19,38,0.633333333,2,264
sub-7011_ses-f2,181,360,0.5028,179,358,5.966666667,2,265
sub-7012_ses-f1,693,761,0.9106,68,136,2.266666667,2,266
sub-7012_ses-f2,492,720,0.6833,228,456,7.6,2,267
sub-7014_ses-f1,160,360,0.4444,200,400,6.666666667,2,268
sub-7014_ses-f2,493,720,0.6847,227,454,7.566666667,2,269
sub-7015_ses-f1,701,832,0.8425,131,262,4.366666667,2,270
sub-7015_ses-f2,396,729,0.5432,333,666,11.1,2,271
sub-7016_ses-f1,501,750,0.668,249,498,8.3,2,272
sub-7016_ses-f2,113,720,0.1569,607,1214,20.23333333,2,273
sub-7017_ses-f1,727,740,0.9824,13,26,0.433333333,2,274
sub-7017_ses-f2,611,725,0.8428,114,228,3.8,2,275
sub-7020_ses-f1,336,740,0.4541,404,808,13.46666667,2,276
sub-7020_ses-f2,210,720,0.2917,510,1020,17,2,277
sub-7021_ses-f1,708,753,0.9402,45,90,1.5,2,278
sub-7022_ses-f1,671,720,0.9319,49,98,1.633333333,2,279
sub-7022_ses-f2,611,727,0.8404,116,232,3.866666667,2,280
sub-7023_ses-f1,558,744,0.75,186,372,6.2,2,281
sub-7023_ses-f2,592,829,0.7141,237,474,7.9,2,282
sub-7024_ses-f1,640,728,0.8791,88,176,2.933333333,2,283
sub-7025_ses-f1,410,729,0.5624,319,638,10.63333333,2,284
sub-7025_ses-f2,214,760,0.2816,546,1092,18.2,2,285
sub-7026_ses-f1,656,920,0.713,264,528,8.8,2,286
sub-7026_ses-f2,714,914,0.7812,200,400,6.666666667,2,287
sub-7026_ses-f3,130,731,0.1778,601,1202,20.03333333,2,288
sub-7027_ses-f1,852,885,0.9627,33,66,1.1,2,289
sub-7027_ses-f2,152,410,0.3707,258,516,8.6,2,290
sub-7027_ses-f3,216,725,0.2979,509,1018,16.96666667,2,291
sub-7028_ses-f1,737,752,0.9801,15,30,0.5,2,292
sub-7028_ses-f2,645,720,0.8958,75,150,2.5,2,293
sub-7029_ses-f1,494,731,0.6758,237,474,7.9,2,294
sub-7029_ses-f2,392,725,0.5407,333,666,11.1,2,295
sub-7030_ses-f1,526,720,0.7306,194,388,6.466666667,2,296
sub-7030_ses-f2,358,794,0.4509,436,872,14.53333333,2,297
sub-7031_ses-f1,18,192,0.0938,174,348,5.8,2,298
sub-7031_ses-f2,26,374,0.0695,348,696,11.6,2,299
sub-7031_ses-f3,472,737,0.6404,265,530,8.833333333,2,300
sub-7032_ses-f1,710,720,0.9861,10,20,0.333333333,2,301
sub-7032_ses-f2,55,73,0.7534,18,36,0.6,2,302
sub-7032_ses-f3,579,740,0.7824,161,322,5.366666667,2,303
sub-7033_ses-f2,336,752,0.4468,416,832,13.86666667,2,304
sub-7034_ses-f1,669,760,0.8803,91,182,3.033333333,2,305
sub-7034_ses-f2,589,912,0.6458,323,646,10.76666667,2,306
sub-7034_ses-f3,160,728,0.2198,568,1136,18.93333333,2,307
sub-7035_ses-f1,13,50,0.26,37,74,1.233333333,2,308
sub-7035_ses-f2,177,727,0.2435,550,1100,18.33333333,2,309
sub-7036_ses-f1,324,745,0.4349,421,842,14.03333333,2,310
sub-7037_ses-f1,759,772,0.9832,13,26,0.433333333,2,311
sub-7037_ses-f2,783,852,0.919,69,138,2.3,2,312
sub-7037_ses-f3,395,720,0.5486,325,650,10.83333333,2,313
sub-7038_ses-f1,560,789,0.7098,229,458,7.633333333,2,314
sub-7038_ses-f2,315,785,0.4013,470,940,15.66666667,2,315
sub-7039_ses-f1,527,785,0.6713,258,516,8.6,2,316
sub-7039_ses-f2,380,727,0.5227,347,694,11.56666667,2,317
sub-7040_ses-f1,425,728,0.5838,303,606,10.1,2,318
sub-7040_ses-f2,302,720,0.4194,418,836,13.93333333,2,319
sub-7040_ses-f3,277,720,0.3847,443,886,14.76666667,2,320
sub-7041_ses-f1,658,754,0.8727,96,192,3.2,2,321
sub-7041_ses-f2,254,735,0.3456,481,962,16.03333333,2,322
sub-7042_ses-f3,353,658,0.5365,305,610,10.16666667,2,323
sub-7043_ses-f2,494,1080,0.4574,586,1172,19.53333333,2,324
sub-7044_ses-f2,468,739,0.6333,271,542,9.033333333,2,325
sub-7045_ses-f1,679,823,0.825,144,288,4.8,2,326
sub-7046_ses-f1,603,812,0.7426,209,418,6.966666667,2,327
sub-7046_ses-f2,34,61,0.5574,27,54,0.9,2,328
sub-7046_ses-f3,308,741,0.4157,433,866,14.43333333,2,329
sub-7047_ses-f1,629,720,0.8736,91,182,3.033333333,2,330
sub-7047_ses-f2,35,64,0.5469,29,58,0.966666667,2,331
sub-7048_ses-f1,5,6,0.8333,1,2,0.033333333,2,332
sub-7048_ses-f2,215,360,0.5972,145,290,4.833333333,2,333
sub-7049_ses-f1,111,360,0.3083,249,498,8.3,2,334
sub-7052_ses-f1,204,518,0.3938,314,628,10.46666667,2,335
sub-7053_ses-f1,486,720,0.675,234,468,7.8,2,336
sub-7054_ses-f1,605,766,0.7898,161,322,5.366666667,2,337
sub-2006_ses-T1,196,420,0.4667,224,448,7.466666667,2.2,1
sub-2011_ses-T1,159,360,0.4417,201,402,6.7,2.2,2
sub-2012_ses-T1,179,180,0.9944,1,2,0.033333333,2.2,3
sub-2013_ses-T1,199,360,0.5528,161,322,5.366666667,2.2,4
sub-2014_ses-T1,246,360,0.6833,114,228,3.8,2.2,5
sub-2015_ses-T1,23,180,0.1278,157,314,5.233333333,2.2,6
sub-2016_ses-T1,221,360,0.6139,139,278,4.633333333,2.2,7
sub-2017_ses-T1,164,180,0.9111,16,32,0.533333333,2.2,8
sub-2018_ses-T1,89,180,0.4944,91,182,3.033333333,2.2,9
sub-2019_ses-T1,281,360,0.7806,79,158,2.633333333,2.2,10
sub-2020_ses-T1,17,26,0.6538,9,18,0.3,2.2,11
sub-2020_ses-T2,159,360,0.4417,201,402,6.7,2.2,12
sub-2021_ses-T1,178,360,0.4944,182,364,6.066666667,2.2,13
sub-2022_ses-T1,191,360,0.5306,169,338,5.633333333,2.2,14
sub-2023_ses-T1,119,360,0.3306,241,482,8.033333333,2.2,15
sub-2024_ses-T2,8,12,0.6667,4,8,0.133333333,2.2,16
sub-2026_ses-T1,129,223,0.5785,94,188,3.133333333,2.2,17
sub-2027_ses-T1,316,360,0.8778,44,88,1.466666667,2.2,18
sub-2028_ses-T1,172,360,0.4778,188,376,6.266666667,2.2,19
sub-2029_ses-T1,232,360,0.6444,128,256,4.266666667,2.2,20
sub-2030_ses-T1,94,360,0.2611,266,532,8.866666667,2.2,21
sub-2031_ses-T1,350,360,0.9722,10,20,0.333333333,2.2,22
sub-2032_ses-T1,93,360,0.2583,267,534,8.9,2.2,23
sub-2033_ses-T1,325,360,0.9028,35,70,1.166666667,2.2,24
sub-2033_ses-T2,116,360,0.3222,244,488,8.133333333,2.2,25
sub-2034_ses-T1,10,180,0.0556,170,340,5.666666667,2.2,26
sub-2035_ses-T1,326,360,0.9056,34,68,1.133333333,2.2,27
sub-2036_ses-T1,272,360,0.7556,88,176,2.933333333,2.2,28
sub-2037_ses-T1,240,360,0.6667,120,240,4,2.2,29
sub-2038_ses-T1,342,360,0.95,18,36,0.6,2.2,30
sub-2039_ses-T1,179,180,0.9944,1,2,0.033333333,2.2,31
sub-2040_ses-T1,289,360,0.8028,71,142,2.366666667,2.2,32
sub-2041_ses-T1,294,360,0.8167,66,132,2.2,2.2,33
sub-2042_ses-T1,56,180,0.3111,124,248,4.133333333,2.2,34
sub-2043_ses-T1,92,360,0.2556,268,536,8.933333333,2.2,35
sub-2044_ses-T1,141,360,0.3917,219,438,7.3,2.2,36
sub-2045_ses-T1,36,180,0.2,144,288,4.8,2.2,37
sub-2046_ses-T1,136,180,0.7556,44,88,1.466666667,2.2,38
sub-2047_ses-T1,74,180,0.4111,106,212,3.533333333,2.2,39
sub-2048_ses-T1,155,180,0.8611,25,50,0.833333333,2.2,40
sub-2049_ses-T1,265,360,0.7361,95,190,3.166666667,2.2,41
sub-2051_ses-T1,344,360,0.9556,16,32,0.533333333,2.2,42
sub-2051_ses-T2,339,360,0.9417,21,42,0.7,2.2,43
sub-2052_ses-T1,210,360,0.5833,150,300,5,2.2,44
sub-2052_ses-T2,47,180,0.2611,133,266,4.433333333,2.2,45
sub-2053_ses-T1,134,360,0.3722,226,452,7.533333333,2.2,46
sub-2055_ses-T1,47,180,0.2611,133,266,4.433333333,2.2,47
sub-2056_ses-T1,351,360,0.975,9,18,0.3,2.2,48
sub-2057_ses-T1,281,360,0.7806,79,158,2.633333333,2.2,49
sub-2058_ses-T1,219,360,0.6083,141,282,4.7,2.2,50
sub-2059_ses-T1,221,360,0.6139,139,278,4.633333333,2.2,51
sub-2061_ses-T1,63,180,0.35,117,234,3.9,2.2,52
sub-2062_ses-T1,320,360,0.8889,40,80,1.333333333,2.2,53
sub-2063_ses-T1,176,360,0.4889,184,368,6.133333333,2.2,54
sub-2064_ses-T1,125,180,0.6944,55,110,1.833333333,2.2,55
sub-2065_ses-T1,40,180,0.2222,140,280,4.666666667,2.2,56
sub-2066_ses-T1,134,180,0.7444,46,92,1.533333333,2.2,57
sub-2066_ses-T2,241,360,0.6694,119,238,3.966666667,2.2,58
sub-2067_ses-T1,245,360,0.6806,115,230,3.833333333,2.2,59
sub-2068_ses-T1,281,360,0.7806,79,158,2.633333333,2.2,60
sub-2069_ses-T1,137,360,0.3806,223,446,7.433333333,2.2,61
sub-2070_ses-T1,250,360,0.6944,110,220,3.666666667,2.2,62
sub-2071_ses-T1,261,360,0.725,99,198,3.3,2.2,63
sub-2072_ses-T1,290,360,0.8056,70,140,2.333333333,2.2,64
sub-2073_ses-T1,241,256,0.9414,15,30,0.5,2.2,65
sub-2073_ses-T2,93,180,0.5167,87,174,2.9,2.2,66
sub-2074_ses-T1,33,180,0.1833,147,294,4.9,2.2,67
sub-2075_ses-T1,146,180,0.8111,34,68,1.133333333,2.2,68
sub-2076_ses-T1,140,360,0.3889,220,440,7.333333333,2.2,69
sub-2076_ses-T2,56,360,0.1556,304,608,10.13333333,2.2,70
sub-2077_ses-T1,329,360,0.9139,31,62,1.033333333,2.2,71
sub-2078_ses-T1,289,360,0.8028,71,142,2.366666667,2.2,72
sub-2079_ses-T1,245,360,0.6806,115,230,3.833333333,2.2,73
sub-2079_ses-T2,111,360,0.3083,249,498,8.3,2.2,74
sub-2080_ses-T1,119,360,0.3306,241,482,8.033333333,2.2,75
sub-2081_ses-T1,287,360,0.7972,73,146,2.433333333,2.2,76
sub-2082_ses-T1,170,360,0.4722,190,380,6.333333333,2.2,77
sub-2083_ses-T1,105,360,0.2917,255,510,8.5,2.2,78
sub-2084_ses-T1,349,360,0.9694,11,22,0.366666667,2.2,79
sub-2085_ses-T1,202,360,0.5611,158,316,5.266666667,2.2,80
sub-2086_ses-T1,64,360,0.1778,296,592,9.866666667,2.2,81
sub-2087_ses-T1,335,360,0.9306,25,50,0.833333333,2.2,82
sub-2088_ses-T1,269,360,0.7472,91,182,3.033333333,2.2,83
sub-2089_ses-T1,169,180,0.9389,11,22,0.366666667,2.2,84
sub-2091_ses-T1,125,360,0.3472,235,470,7.833333333,2.2,85
sub-2092_ses-T1,258,360,0.7167,102,204,3.4,2.2,86
sub-2093_ses-T1,266,360,0.7389,94,188,3.133333333,2.2,87
sub-2094_ses-T1,170,180,0.9444,10,20,0.333333333,2.2,88
sub-2095_ses-T1,298,360,0.8278,62,124,2.066666667,2.2,89
sub-2096_ses-T1,245,360,0.6806,115,230,3.833333333,2.2,90
sub-2097_ses-T1,436,540,0.8074,104,208,3.466666667,2.2,91
sub-2098_ses-T1,90,360,0.25,270,540,9,2.2,92
sub-2099_ses-T1,116,180,0.6444,64,128,2.133333333,2.2,93
sub-2099_ses-T2,165,360,0.4583,195,390,6.5,2.2,94
sub-2100_ses-T1,119,180,0.6611,61,122,2.033333333,2.2,95
sub-2100_ses-T2,136,360,0.3778,224,448,7.466666667,2.2,96
sub-2101_ses-T1,232,360,0.6444,128,256,4.266666667,2.2,97
sub-2101_ses-T2,142,360,0.3944,218,436,7.266666667,2.2,98
sub-2102_ses-T1,298,360,0.8278,62,124,2.066666667,2.2,99
sub-2103_ses-T1,213,360,0.5917,147,294,4.9,2.2,100
sub-2103_ses-T2,306,360,0.85,54,108,1.8,2.2,101
sub-2104_ses-T1,328,387,0.8475,59,118,1.966666667,2.2,102
sub-2105_ses-T1,293,360,0.8139,67,134,2.233333333,2.2,103
sub-2105_ses-T2,300,360,0.8333,60,120,2,2.2,104
sub-2106_ses-T1,309,360,0.8583,51,102,1.7,2.2,105
sub-2107_ses-T1,148,360,0.4111,212,424,7.066666667,2.2,106
sub-2107_ses-T2,181,360,0.5028,179,358,5.966666667,2.2,107
sub-2108_ses-T1,348,360,0.9667,12,24,0.4,2.2,108
sub-2108_ses-T3,120,141,0.8511,21,42,0.7,2.2,109
sub-2109_ses-T1,117,180,0.65,63,126,2.1,2.2,110
sub-2110_ses-T1,238,274,0.8686,36,72,1.2,2.2,111
sub-2115_ses-T1,280,360,0.7778,80,160,2.666666667,2.2,112
sub-2115_ses-T2,205,360,0.5694,155,310,5.166666667,2.2,113
sub-2117_ses-T1,278,360,0.7722,82,164,2.733333333,2.2,114
sub-2117_ses-T2,110,360,0.3056,250,500,8.333333333,2.2,115
sub-2118_ses-T1,193,360,0.5361,167,334,5.566666667,2.2,116
sub-2120_ses-T1,249,360,0.6917,111,222,3.7,2.2,117
sub-2122_ses-T1,245,360,0.6806,115,230,3.833333333,2.2,118
sub-2123_ses-T1,330,360,0.9167,30,60,1,2.2,119
sub-2124_ses-T1,343,404,0.849,61,122,2.033333333,2.2,120
sub-2126_ses-T1,260,360,0.7222,100,200,3.333333333,2.2,121
sub-2128_ses-T1,287,360,0.7972,73,146,2.433333333,2.2,122
sub-2133_ses-T1,209,360,0.5806,151,302,5.033333333,2.2,123
sub-2135_ses-T1,7,19,0.3684,12,24,0.4,2.2,124
sub-2136_ses-T1,405,720,0.5625,315,630,10.5,2.2,125
sub-2137_ses-T1,389,720,0.5403,331,662,11.03333333,2.2,126
sub-2137_ses-T2,114,360,0.3167,246,492,8.2,2.2,127
sub-2138_ses-T1,320,360,0.8889,40,80,1.333333333,2.2,128
sub-2139_ses-T1,106,360,0.2944,254,508,8.466666667,2.2,129
sub-2140_ses-T1,377,379,0.9947,2,4,0.066666667,2.2,130
sub-2141_ses-T1,172,360,0.4778,188,376,6.266666667,2.2,131
sub-2142_ses-T2,327,360,0.9083,33,66,1.1,2.2,132
sub-2143_ses-T1,211,360,0.5861,149,298,4.966666667,2.2,133
sub-2144_ses-T1,237,372,0.6371,135,270,4.5,2.2,134
sub-2145_ses-T1,232,360,0.6444,128,256,4.266666667,2.2,135
sub-2145_ses-T2,65,360,0.1806,295,590,9.833333333,2.2,136
sub-2146_ses-T1,323,360,0.8972,37,74,1.233333333,2.2,137
sub-2146_ses-T2,364,720,0.5056,356,712,11.86666667,2.2,138
sub-2147_ses-T1,232,360,0.6444,128,256,4.266666667,2.2,139
sub-2147_ses-T2,260,360,0.7222,100,200,3.333333333,2.2,140
sub-2148_ses-T1,353,399,0.8847,46,92,1.533333333,2.2,141
sub-2149_ses-T1,258,360,0.7167,102,204,3.4,2.2,142
sub-2150_ses-T1,329,360,0.9139,31,62,1.033333333,2.2,143
sub-2150_ses-T2,223,360,0.6194,137,274,4.566666667,2.2,144
sub-2151_ses-T1,434,720,0.6028,286,572,9.533333333,2.2,145
sub-2151_ses-T2,457,773,0.5912,316,632,10.53333333,2.2,146
sub-2152_ses-T1,342,360,0.95,18,36,0.6,2.2,147
sub-2152_ses-T2,183,360,0.5083,177,354,5.9,2.2,148
sub-2153_ses-T1,350,383,0.9138,33,66,1.1,2.2,149
sub-2154_ses-T2,321,360,0.8917,39,78,1.3,2.2,150
sub-2155_ses-T1,247,360,0.6861,113,226,3.766666667,2.2,151
sub-2156_ses-T1,177,360,0.4917,183,366,6.1,2.2,152
sub-2157_ses-T1,306,360,0.85,54,108,1.8,2.2,153
sub-2158_ses-T1,252,360,0.7,108,216,3.6,2.2,154
sub-2159_ses-T1,194,360,0.5389,166,332,5.533333333,2.2,155
sub-2160_ses-T1,151,360,0.4194,209,418,6.966666667,2.2,156
sub-2161_ses-T1,253,360,0.7028,107,214,3.566666667,2.2,157
sub-2162_ses-T1,293,360,0.8139,67,134,2.233333333,2.2,158
sub-2163_ses-T1,330,399,0.8271,69,138,2.3,2.2,159
sub-2164_ses-T1,196,720,0.2722,524,1048,17.46666667,2.2,160
sub-2164_ses-T2,443,720,0.6153,277,554,9.233333333,2.2,161
sub-2165_ses-T1,265,481,0.5509,216,432,7.2,2.2,162
sub-2166_ses-T1,267,360,0.7417,93,186,3.1,2.2,163
sub-2166_ses-T2,182,360,0.5056,178,356,5.933333333,2.2,164
sub-2167_ses-T1,323,370,0.873,47,94,1.566666667,2.2,165
sub-2168_ses-T1,304,360,0.8444,56,112,1.866666667,2.2,166
sub-2168_ses-T2,258,360,0.7167,102,204,3.4,2.2,167
sub-2169_ses-T1,315,360,0.875,45,90,1.5,2.2,168
sub-2169_ses-T2,188,360,0.5222,172,344,5.733333333,2.2,169
sub-2170_ses-T1,150,264,0.5682,114,228,3.8,2.2,170
sub-2171_ses-T1,304,374,0.8128,70,140,2.333333333,2.2,171
sub-2171_ses-T2,245,483,0.5072,238,476,7.933333333,2.2,172
sub-2171_ses-T3,197,577,0.3414,380,760,12.66666667,2.2,173
sub-2172_ses-T1,273,513,0.5322,240,480,8,2.2,174
sub-2172_ses-T2,320,386,0.829,66,132,2.2,2.2,175
sub-2173_ses-T1,135,360,0.375,225,450,7.5,2.2,176
sub-2174_ses-T1,244,416,0.5865,172,344,5.733333333,2.2,177
sub-2175_ses-T1,580,679,0.8542,99,198,3.3,2.2,178
sub-2176_ses-T1,142,360,0.3944,218,436,7.266666667,2.2,179
sub-2176_ses-T2,0,360,0,360,720,12,2.2,180
sub-2177_ses-T1,663,695,0.954,32,64,1.066666667,2.2,181
sub-2177_ses-T2,547,736,0.7432,189,378,6.3,2.2,182
sub-2178_ses-T2,171,360,0.475,189,378,6.3,2.2,183
sub-2179_ses-T2,452,720,0.6278,268,536,8.933333333,2.2,184
sub-2180_ses-T1,168,360,0.4667,192,384,6.4,2.2,185
sub-2180_ses-T2,62,360,0.1722,298,596,9.933333333,2.2,186
sub-2181_ses-T1,310,360,0.8611,50,100,1.666666667,2.2,187
sub-2182_ses-T1,38,51,0.7451,13,26,0.433333333,2.2,188
sub-2184_ses-T1,308,391,0.7877,83,166,2.766666667,2.2,189
sub-2185_ses-T1,283,360,0.7861,77,154,2.566666667,2.2,190
sub-2186_ses-T1,134,371,0.3612,237,474,7.9,2.2,191
sub-2187_ses-T1,41,48,0.8542,7,14,0.233333333,2.2,192
sub-2188_ses-T1,404,445,0.9079,41,82,1.366666667,2.2,193
sub-2189_ses-T1,181,204,0.8873,23,46,0.766666667,2.2,194
sub-2190_ses-T1,197,360,0.5472,163,326,5.433333333,2.2,195
sub-2191_ses-T1,320,360,0.8889,40,80,1.333333333,2.2,196
sub-2191_ses-T2,12,360,0.0333,348,696,11.6,2.2,197
sub-2192_ses-T1,307,360,0.8528,53,106,1.766666667,2.2,198
sub-2193_ses-T2,497,625,0.7952,128,256,4.266666667,2.2,199
sub-2194_ses-T1,323,415,0.7783,92,184,3.066666667,2.2,200
sub-2195_ses-T1,77,360,0.2139,283,566,9.433333333,2.2,201
sub-2196_ses-T1,152,416,0.3654,264,528,8.8,2.2,202
sub-2197_ses-T1,350,439,0.7973,89,178,2.966666667,2.2,203
sub-2197_ses-T2,167,384,0.4349,217,434,7.233333333,2.2,204
sub-2198_ses-T1,304,407,0.7469,103,206,3.433333333,2.2,205
sub-2199_ses-T1,305,404,0.755,99,198,3.3,2.2,206
sub-2200_ses-T1,143,360,0.3972,217,434,7.233333333,2.2,207
sub-2201_ses-T1,295,360,0.8194,65,130,2.166666667,2.2,208
sub-2202_ses-T1,241,606,0.3977,365,730,12.16666667,2.2,209
sub-2203_ses-T1,218,360,0.6056,142,284,4.733333333,2.2,210
sub-2204_ses-T1,273,360,0.7583,87,174,2.9,2.2,211
sub-2204_ses-T2,280,360,0.7778,80,160,2.666666667,2.2,212
sub-2205_ses-T1,237,360,0.6583,123,246,4.1,2.2,213
sub-2206_ses-T1,320,360,0.8889,40,80,1.333333333,2.2,214
sub-2206_ses-T2,310,720,0.4306,410,820,13.66666667,2.2,215
sub-2207_ses-T1,101,360,0.2806,259,518,8.633333333,2.2,216
sub-2207_ses-T2,135,360,0.375,225,450,7.5,2.2,217
sub-2208_ses-T1,297,360,0.825,63,126,2.1,2.2,218
sub-2208_ses-T2,187,360,0.5194,173,346,5.766666667,2.2,219
sub-2209_ses-T1,266,341,0.7801,75,150,2.5,2.2,220
sub-2210_ses-T1,29,38,0.7632,9,18,0.3,2.2,221
sub-2211_ses-T1,295,360,0.8194,65,130,2.166666667,2.2,222
sub-2212_ses-T1,304,360,0.8444,56,112,1.866666667,2.2,223
sub-2213_ses-T1,150,286,0.5245,136,272,4.533333333,2.2,224
sub-2214_ses-T1,344,373,0.9223,29,58,0.966666667,2.2,225
sub-2215_ses-T1,319,360,0.8861,41,82,1.366666667,2.2,226
sub-2216_ses-T1,32,86,0.3721,54,108,1.8,2.2,227
sub-2216_ses-T2,85,181,0.4696,96,192,3.2,2.2,228
sub-2217_ses-T1,119,360,0.3306,241,482,8.033333333,2.2,229
sub-2217_ses-T2,19,360,0.0528,341,682,11.36666667,2.2,230
sub-2218_ses-T1,211,360,0.5861,149,298,4.966666667,2.2,231
sub-2218_ses-T2,216,720,0.3,504,1008,16.8,2.2,232
sub-2219_ses-T1,338,360,0.9389,22,44,0.733333333,2.2,233
sub-2220_ses-T1,321,360,0.8917,39,78,1.3,2.2,234
sub-2220_ses-T2,258,720,0.3583,462,924,15.4,2.2,235
sub-2221_ses-T1,133,360,0.3694,227,454,7.566666667,2.2,236
sub-2221_ses-T2,398,720,0.5528,322,644,10.73333333,2.2,237
sub-2222_ses-T1,169,360,0.4694,191,382,6.366666667,2.2,238
sub-2223_ses-T1,268,360,0.7444,92,184,3.066666667,2.2,239
sub-2223_ses-T2,368,720,0.5111,352,704,11.73333333,2.2,240
sub-2224_ses-T1,198,379,0.5224,181,362,6.033333333,2.2,241
sub-2225_ses-T1,300,360,0.8333,60,120,2,2.2,242
sub-2225_ses-T2,406,759,0.5349,353,706,11.76666667,2.2,243
sub-2226_ses-T1,123,365,0.337,242,484,8.066666667,2.2,244
sub-2226_ses-T2,91,360,0.2528,269,538,8.966666667,2.2,245
sub-2227_ses-T1,272,360,0.7556,88,176,2.933333333,2.2,246
sub-2228_ses-T1,307,360,0.8528,53,106,1.766666667,2.2,247
sub-2228_ses-T2,402,729,0.5514,327,654,10.9,2.2,248
sub-2229_ses-T1,329,360,0.9139,31,62,1.033333333,2.2,249
sub-2229_ses-T2,143,390,0.3667,247,494,8.233333333,2.2,250
sub-2230_ses-T1,355,398,0.892,43,86,1.433333333,2.2,251
sub-7001_ses-f2,232,720,0.3222,488,976,16.26666667,2.2,252
sub-7001_ses-f3,75,720,0.1042,645,1290,21.5,2.2,253
sub-7002_ses-f1,349,720,0.4847,371,742,12.36666667,2.2,254
sub-7002_ses-f2,322,720,0.4472,398,796,13.26666667,2.2,255
sub-7003_ses-f1,186,360,0.5167,174,348,5.8,2.2,256
sub-7003_ses-f2,6,180,0.0333,174,348,5.8,2.2,257
sub-7004_ses-f3,330,724,0.4558,394,788,13.13333333,2.2,258
sub-7006_ses-f1,44,52,0.8462,8,16,0.266666667,2.2,259
sub-7008_ses-f1,513,720,0.7125,207,414,6.9,2.2,260
sub-7008_ses-f2,127,720,0.1764,593,1186,19.76666667,2.2,261
sub-7009_ses-f1,382,720,0.5306,338,676,11.26666667,2.2,262
sub-7009_ses-f2,195,720,0.2708,525,1050,17.5,2.2,263
sub-7011_ses-f1,893,917,0.9738,24,48,0.8,2.2,264
sub-7011_ses-f2,163,360,0.4528,197,394,6.566666667,2.2,265
sub-7012_ses-f1,683,761,0.8975,78,156,2.6,2.2,266
sub-7012_ses-f2,456,720,0.6333,264,528,8.8,2.2,267
sub-7014_ses-f1,134,360,0.3722,226,452,7.533333333,2.2,268
sub-7014_ses-f2,435,720,0.6042,285,570,9.5,2.2,269
sub-7015_ses-f1,682,832,0.8197,150,300,5,2.2,270
sub-7015_ses-f2,356,729,0.4883,373,746,12.43333333,2.2,271
sub-7016_ses-f1,466,750,0.6213,284,568,9.466666667,2.2,272
sub-7016_ses-f2,98,720,0.1361,622,1244,20.73333333,2.2,273
sub-7017_ses-f1,722,740,0.9757,18,36,0.6,2.2,274
sub-7017_ses-f2,591,725,0.8152,134,268,4.466666667,2.2,275
sub-7020_ses-f1,285,740,0.3851,455,910,15.16666667,2.2,276
sub-7020_ses-f2,202,720,0.2806,518,1036,17.26666667,2.2,277
sub-7021_ses-f1,690,753,0.9163,63,126,2.1,2.2,278
sub-7022_ses-f1,657,720,0.9125,63,126,2.1,2.2,279
sub-7022_ses-f2,561,727,0.7717,166,332,5.533333333,2.2,280
sub-7023_ses-f1,520,744,0.6989,224,448,7.466666667,2.2,281
sub-7023_ses-f2,565,829,0.6815,264,528,8.8,2.2,282
sub-7024_ses-f1,620,728,0.8516,108,216,3.6,2.2,283
sub-7025_ses-f1,370,729,0.5075,359,718,11.96666667,2.2,284
sub-7025_ses-f2,202,760,0.2658,558,1116,18.6,2.2,285
sub-7026_ses-f1,620,920,0.6739,300,600,10,2.2,286
sub-7026_ses-f2,676,914,0.7396,238,476,7.933333333,2.2,287
sub-7026_ses-f3,119,731,0.1628,612,1224,20.4,2.2,288
sub-7027_ses-f1,846,885,0.9559,39,78,1.3,2.2,289
sub-7027_ses-f2,141,410,0.3439,269,538,8.966666667,2.2,290
sub-7027_ses-f3,173,725,0.2386,552,1104,18.4,2.2,291
sub-7028_ses-f1,735,752,0.9774,17,34,0.566666667,2.2,292
sub-7028_ses-f2,622,720,0.8639,98,196,3.266666667,2.2,293
sub-7029_ses-f1,462,731,0.632,269,538,8.966666667,2.2,294
sub-7029_ses-f2,354,725,0.4883,371,742,12.36666667,2.2,295
sub-7030_ses-f1,504,720,0.7,216,432,7.2,2.2,296
sub-7030_ses-f2,326,794,0.4106,468,936,15.6,2.2,297
sub-7031_ses-f1,14,192,0.0729,178,356,5.933333333,2.2,298
sub-7031_ses-f2,21,374,0.0561,353,706,11.76666667,2.2,299
sub-7031_ses-f3,432,737,0.5862,305,610,10.16666667,2.2,300
sub-7032_ses-f1,709,720,0.9847,11,22,0.366666667,2.2,301
sub-7032_ses-f2,54,73,0.7397,19,38,0.633333333,2.2,302
sub-7032_ses-f3,550,740,0.7432,190,380,6.333333333,2.2,303
sub-7033_ses-f2,320,752,0.4255,432,864,14.4,2.2,304
sub-7034_ses-f1,652,760,0.8579,108,216,3.6,2.2,305
sub-7034_ses-f2,564,912,0.6184,348,696,11.6,2.2,306
sub-7034_ses-f3,139,728,0.1909,589,1178,19.63333333,2.2,307
sub-7035_ses-f1,11,50,0.22,39,78,1.3,2.2,308
sub-7035_ses-f2,154,727,0.2118,573,1146,19.1,2.2,309
sub-7036_ses-f1,281,745,0.3772,464,928,15.46666667,2.2,310
sub-7037_ses-f1,754,772,0.9767,18,36,0.6,2.2,311
sub-7037_ses-f2,763,852,0.8955,89,178,2.966666667,2.2,312
sub-7037_ses-f3,335,720,0.4653,385,770,12.83333333,2.2,313
sub-7038_ses-f1,539,789,0.6831,250,500,8.333333333,2.2,314
sub-7038_ses-f2,288,785,0.3669,497,994,16.56666667,2.2,315
sub-7039_ses-f1,501,785,0.6382,284,568,9.466666667,2.2,316
sub-7039_ses-f2,340,727,0.4677,387,774,12.9,2.2,317
sub-7040_ses-f1,399,728,0.5481,329,658,10.96666667,2.2,318
sub-7040_ses-f2,269,720,0.3736,451,902,15.03333333,2.2,319
sub-7040_ses-f3,249,720,0.3458,471,942,15.7,2.2,320
sub-7041_ses-f1,639,754,0.8475,115,230,3.833333333,2.2,321
sub-7041_ses-f2,240,735,0.3265,495,990,16.5,2.2,322
sub-7042_ses-f3,328,658,0.4985,330,660,11,2.2,323
sub-7043_ses-f2,450,1080,0.4167,630,1260,21,2.2,324
sub-7044_ses-f2,436,739,0.59,303,606,10.1,2.2,325
sub-7045_ses-f1,655,823,0.7959,168,336,5.6,2.2,326
sub-7046_ses-f1,572,812,0.7044,240,480,8,2.2,327
sub-7046_ses-f2,33,61,0.541,28,56,0.933333333,2.2,328
sub-7046_ses-f3,250,741,0.3374,491,982,16.36666667,2.2,329
sub-7047_ses-f1,594,720,0.825,126,252,4.2,2.2,330
sub-7047_ses-f2,34,64,0.5312,30,60,1,2.2,331
sub-7048_ses-f1,5,6,0.8333,1,2,0.033333333,2.2,332
sub-7048_ses-f2,197,360,0.5472,163,326,5.433333333,2.2,333
sub-7049_ses-f1,94,360,0.2611,266,532,8.866666667,2.2,334
sub-7052_ses-f1,166,518,0.3205,352,704,11.73333333,2.2,335
sub-7053_ses-f1,447,720,0.6208,273,546,9.1,2.2,336
sub-7054_ses-f1,575,766,0.7507,191,382,6.366666667,2.2,337
sub-2006_ses-T1,183,420,0.4357,237,474,7.9,2.4,1
sub-2011_ses-T1,148,360,0.4111,212,424,7.066666667,2.4,2
sub-2012_ses-T1,179,180,0.9944,1,2,0.033333333,2.4,3
sub-2013_ses-T1,187,360,0.5194,173,346,5.766666667,2.4,4
sub-2014_ses-T1,230,360,0.6389,130,260,4.333333333,2.4,5
sub-2015_ses-T1,20,180,0.1111,160,320,5.333333333,2.4,6
sub-2016_ses-T1,202,360,0.5611,158,316,5.266666667,2.4,7
sub-2017_ses-T1,162,180,0.9,18,36,0.6,2.4,8
sub-2018_ses-T1,77,180,0.4278,103,206,3.433333333,2.4,9
sub-2019_ses-T1,266,360,0.7389,94,188,3.133333333,2.4,10
sub-2020_ses-T1,17,26,0.6538,9,18,0.3,2.4,11
sub-2020_ses-T2,144,360,0.4,216,432,7.2,2.4,12
sub-2021_ses-T1,161,360,0.4472,199,398,6.633333333,2.4,13
sub-2022_ses-T1,184,360,0.5111,176,352,5.866666667,2.4,14
sub-2023_ses-T1,110,360,0.3056,250,500,8.333333333,2.4,15
sub-2024_ses-T2,7,12,0.5833,5,10,0.166666667,2.4,16
sub-2026_ses-T1,118,223,0.5291,105,210,3.5,2.4,17
sub-2027_ses-T1,300,360,0.8333,60,120,2,2.4,18
sub-2028_ses-T1,155,360,0.4306,205,410,6.833333333,2.4,19
sub-2029_ses-T1,214,360,0.5944,146,292,4.866666667,2.4,20
sub-2030_ses-T1,83,360,0.2306,277,554,9.233333333,2.4,21
sub-2031_ses-T1,350,360,0.9722,10,20,0.333333333,2.4,22
sub-2032_ses-T1,86,360,0.2389,274,548,9.133333333,2.4,23
sub-2033_ses-T1,317,360,0.8806,43,86,1.433333333,2.4,24
sub-2033_ses-T2,112,360,0.3111,248,496,8.266666667,2.4,25
sub-2034_ses-T1,9,180,0.05,171,342,5.7,2.4,26
sub-2035_ses-T1,318,360,0.8833,42,84,1.4,2.4,27
sub-2036_ses-T1,254,360,0.7056,106,212,3.533333333,2.4,28
sub-2037_ses-T1,229,360,0.6361,131,262,4.366666667,2.4,29
sub-2038_ses-T1,333,360,0.925,27,54,0.9,2.4,30
sub-2039_ses-T1,176,180,0.9778,4,8,0.133333333,2.4,31
sub-2040_ses-T1,284,360,0.7889,76,152,2.533333333,2.4,32
sub-2041_ses-T1,275,360,0.7639,85,170,2.833333333,2.4,33
sub-2042_ses-T1,49,180,0.2722,131,262,4.366666667,2.4,34
sub-2043_ses-T1,86,360,0.2389,274,548,9.133333333,2.4,35
sub-2044_ses-T1,133,360,0.3694,227,454,7.566666667,2.4,36
sub-2045_ses-T1,26,180,0.1444,154,308,5.133333333,2.4,37
sub-2046_ses-T1,125,180,0.6944,55,110,1.833333333,2.4,38
sub-2047_ses-T1,61,180,0.3389,119,238,3.966666667,2.4,39
sub-2048_ses-T1,148,180,0.8222,32,64,1.066666667,2.4,40
sub-2049_ses-T1,246,360,0.6833,114,228,3.8,2.4,41
sub-2051_ses-T1,335,360,0.9306,25,50,0.833333333,2.4,42
sub-2051_ses-T2,337,360,0.9361,23,46,0.766666667,2.4,43
sub-2052_ses-T1,199,360,0.5528,161,322,5.366666667,2.4,44
sub-2052_ses-T2,42,180,0.2333,138,276,4.6,2.4,45
sub-2053_ses-T1,125,360,0.3472,235,470,7.833333333,2.4,46
sub-2055_ses-T1,44,180,0.2444,136,272,4.533333333,2.4,47
sub-2056_ses-T1,350,360,0.9722,10,20,0.333333333,2.4,48
sub-2057_ses-T1,260,360,0.7222,100,200,3.333333333,2.4,49
sub-2058_ses-T1,210,360,0.5833,150,300,5,2.4,50
sub-2059_ses-T1,212,360,0.5889,148,296,4.933333333,2.4,51
sub-2061_ses-T1,59,180,0.3278,121,242,4.033333333,2.4,52
sub-2062_ses-T1,311,360,0.8639,49,98,1.633333333,2.4,53
sub-2063_ses-T1,162,360,0.45,198,396,6.6,2.4,54
sub-2064_ses-T1,119,180,0.6611,61,122,2.033333333,2.4,55
sub-2065_ses-T1,32,180,0.1778,148,296,4.933333333,2.4,56
sub-2066_ses-T1,126,180,0.7,54,108,1.8,2.4,57
sub-2066_ses-T2,224,360,0.6222,136,272,4.533333333,2.4,58
sub-2067_ses-T1,226,360,0.6278,134,268,4.466666667,2.4,59
sub-2068_ses-T1,270,360,0.75,90,180,3,2.4,60
sub-2069_ses-T1,115,360,0.3194,245,490,8.166666667,2.4,61
sub-2070_ses-T1,237,360,0.6583,123,246,4.1,2.4,62
sub-2071_ses-T1,245,360,0.6806,115,230,3.833333333,2.4,63
sub-2072_ses-T1,282,360,0.7833,78,156,2.6,2.4,64
sub-2073_ses-T1,241,256,0.9414,15,30,0.5,2.4,65
sub-2073_ses-T2,75,180,0.4167,105,210,3.5,2.4,66
sub-2074_ses-T1,26,180,0.1444,154,308,5.133333333,2.4,67
sub-2075_ses-T1,139,180,0.7722,41,82,1.366666667,2.4,68
sub-2076_ses-T1,137,360,0.3806,223,446,7.433333333,2.4,69
sub-2076_ses-T2,54,360,0.15,306,612,10.2,2.4,70
sub-2077_ses-T1,319,360,0.8861,41,82,1.366666667,2.4,71
sub-2078_ses-T1,270,360,0.75,90,180,3,2.4,72
sub-2079_ses-T1,225,360,0.625,135,270,4.5,2.4,73
sub-2079_ses-T2,101,360,0.2806,259,518,8.633333333,2.4,74
sub-2080_ses-T1,110,360,0.3056,250,500,8.333333333,2.4,75
sub-2081_ses-T1,272,360,0.7556,88,176,2.933333333,2.4,76
sub-2082_ses-T1,156,360,0.4333,204,408,6.8,2.4,77
sub-2083_ses-T1,97,360,0.2694,263,526,8.766666667,2.4,78
sub-2084_ses-T1,344,360,0.9556,16,32,0.533333333,2.4,79
sub-2085_ses-T1,189,360,0.525,171,342,5.7,2.4,80
sub-2086_ses-T1,56,360,0.1556,304,608,10.13333333,2.4,81
sub-2087_ses-T1,333,360,0.925,27,54,0.9,2.4,82
sub-2088_ses-T1,252,360,0.7,108,216,3.6,2.4,83
sub-2089_ses-T1,166,180,0.9222,14,28,0.466666667,2.4,84
sub-2091_ses-T1,108,360,0.3,252,504,8.4,2.4,85
sub-2092_ses-T1,242,360,0.6722,118,236,3.933333333,2.4,86
sub-2093_ses-T1,258,360,0.7167,102,204,3.4,2.4,87
sub-2094_ses-T1,169,180,0.9389,11,22,0.366666667,2.4,88
sub-2095_ses-T1,285,360,0.7917,75,150,2.5,2.4,89
sub-2096_ses-T1,232,360,0.6444,128,256,4.266666667,2.4,90
sub-2097_ses-T1,412,540,0.763,128,256,4.266666667,2.4,91
sub-2098_ses-T1,78,360,0.2167,282,564,9.4,2.4,92
sub-2099_ses-T1,100,180,0.5556,80,160,2.666666667,2.4,93
sub-2099_ses-T2,141,360,0.3917,219,438,7.3,2.4,94
sub-2100_ses-T1,114,180,0.6333,66,132,2.2,2.4,95
sub-2100_ses-T2,119,360,0.3306,241,482,8.033333333,2.4,96
sub-2101_ses-T1,219,360,0.6083,141,282,4.7,2.4,97
sub-2101_ses-T2,134,360,0.3722,226,452,7.533333333,2.4,98
sub-2102_ses-T1,282,360,0.7833,78,156,2.6,2.4,99
sub-2103_ses-T1,200,360,0.5556,160,320,5.333333333,2.4,100
sub-2103_ses-T2,299,360,0.8306,61,122,2.033333333,2.4,101
sub-2104_ses-T1,320,387,0.8269,67,134,2.233333333,2.4,102
sub-2105_ses-T1,281,360,0.7806,79,158,2.633333333,2.4,103
sub-2105_ses-T2,284,360,0.7889,76,152,2.533333333,2.4,104
sub-2106_ses-T1,301,360,0.8361,59,118,1.966666667,2.4,105
sub-2107_ses-T1,137,360,0.3806,223,446,7.433333333,2.4,106
sub-2107_ses-T2,170,360,0.4722,190,380,6.333333333,2.4,107
sub-2108_ses-T1,339,360,0.9417,21,42,0.7,2.4,108
sub-2108_ses-T3,114,141,0.8085,27,54,0.9,2.4,109
sub-2109_ses-T1,108,180,0.6,72,144,2.4,2.4,110
sub-2110_ses-T1,230,274,0.8394,44,88,1.466666667,2.4,111
sub-2115_ses-T1,267,360,0.7417,93,186,3.1,2.4,112
sub-2115_ses-T2,190,360,0.5278,170,340,5.666666667,2.4,113
sub-2117_ses-T1,266,360,0.7389,94,188,3.133333333,2.4,114
sub-2117_ses-T2,97,360,0.2694,263,526,8.766666667,2.4,115
sub-2118_ses-T1,172,360,0.4778,188,376,6.266666667,2.4,116
sub-2120_ses-T1,236,360,0.6556,124,248,4.133333333,2.4,117
sub-2122_ses-T1,228,360,0.6333,132,264,4.4,2.4,118
sub-2123_ses-T1,329,360,0.9139,31,62,1.033333333,2.4,119
sub-2124_ses-T1,342,404,0.8465,62,124,2.066666667,2.4,120
sub-2126_ses-T1,252,360,0.7,108,216,3.6,2.4,121
sub-2128_ses-T1,274,360,0.7611,86,172,2.866666667,2.4,122
sub-2133_ses-T1,193,360,0.5361,167,334,5.566666667,2.4,123
sub-2135_ses-T1,7,19,0.3684,12,24,0.4,2.4,124
sub-2136_ses-T1,382,720,0.5306,338,676,11.26666667,2.4,125
sub-2137_ses-T1,355,720,0.4931,365,730,12.16666667,2.4,126
sub-2137_ses-T2,110,360,0.3056,250,500,8.333333333,2.4,127
sub-2138_ses-T1,305,360,0.8472,55,110,1.833333333,2.4,128
sub-2139_ses-T1,100,360,0.2778,260,520,8.666666667,2.4,129
sub-2140_ses-T1,377,379,0.9947,2,4,0.066666667,2.4,130
sub-2141_ses-T1,161,360,0.4472,199,398,6.633333333,2.4,131
sub-2142_ses-T2,319,360,0.8861,41,82,1.366666667,2.4,132
sub-2143_ses-T1,198,360,0.55,162,324,5.4,2.4,133
sub-2144_ses-T1,221,372,0.5941,151,302,5.033333333,2.4,134
sub-2145_ses-T1,217,360,0.6028,143,286,4.766666667,2.4,135
sub-2145_ses-T2,60,360,0.1667,300,600,10,2.4,136
sub-2146_ses-T1,317,360,0.8806,43,86,1.433333333,2.4,137
sub-2146_ses-T2,344,720,0.4778,376,752,12.53333333,2.4,138
sub-2147_ses-T1,212,360,0.5889,148,296,4.933333333,2.4,139
sub-2147_ses-T2,243,360,0.675,117,234,3.9,2.4,140
sub-2148_ses-T1,347,399,0.8697,52,104,1.733333333,2.4,141
sub-2149_ses-T1,242,360,0.6722,118,236,3.933333333,2.4,142
sub-2150_ses-T1,324,360,0.9,36,72,1.2,2.4,143
sub-2150_ses-T2,208,360,0.5778,152,304,5.066666667,2.4,144
sub-2151_ses-T1,388,720,0.5389,332,664,11.06666667,2.4,145
sub-2151_ses-T2,444,773,0.5744,329,658,10.96666667,2.4,146
sub-2152_ses-T1,337,360,0.9361,23,46,0.766666667,2.4,147
sub-2152_ses-T2,170,360,0.4722,190,380,6.333333333,2.4,148
sub-2153_ses-T1,341,383,0.8903,42,84,1.4,2.4,149
sub-2154_ses-T2,317,360,0.8806,43,86,1.433333333,2.4,150
sub-2155_ses-T1,230,360,0.6389,130,260,4.333333333,2.4,151
sub-2156_ses-T1,165,360,0.4583,195,390,6.5,2.4,152
sub-2157_ses-T1,294,360,0.8167,66,132,2.2,2.4,153
sub-2158_ses-T1,238,360,0.6611,122,244,4.066666667,2.4,154
sub-2159_ses-T1,176,360,0.4889,184,368,6.133333333,2.4,155
sub-2160_ses-T1,132,360,0.3667,228,456,7.6,2.4,156
sub-2161_ses-T1,247,360,0.6861,113,226,3.766666667,2.4,157
sub-2162_ses-T1,277,360,0.7694,83,166,2.766666667,2.4,158
sub-2163_ses-T1,319,399,0.7995,80,160,2.666666667,2.4,159
sub-2164_ses-T1,186,720,0.2583,534,1068,17.8,2.4,160
sub-2164_ses-T2,419,720,0.5819,301,602,10.03333333,2.4,161
sub-2165_ses-T1,243,481,0.5052,238,476,7.933333333,2.4,162
sub-2166_ses-T1,253,360,0.7028,107,214,3.566666667,2.4,163
sub-2166_ses-T2,178,360,0.4944,182,364,6.066666667,2.4,164
sub-2167_ses-T1,311,370,0.8405,59,118,1.966666667,2.4,165
sub-2168_ses-T1,287,360,0.7972,73,146,2.433333333,2.4,166
sub-2168_ses-T2,240,360,0.6667,120,240,4,2.4,167
sub-2169_ses-T1,299,360,0.8306,61,122,2.033333333,2.4,168
sub-2169_ses-T2,172,360,0.4778,188,376,6.266666667,2.4,169
sub-2170_ses-T1,141,264,0.5341,123,246,4.1,2.4,170
sub-2171_ses-T1,302,374,0.8075,72,144,2.4,2.4,171
sub-2171_ses-T2,228,483,0.472,255,510,8.5,2.4,172
sub-2171_ses-T3,179,577,0.3102,398,796,13.26666667,2.4,173
sub-2172_ses-T1,256,513,0.499,257,514,8.566666667,2.4,174
sub-2172_ses-T2,306,386,0.7927,80,160,2.666666667,2.4,175
sub-2173_ses-T1,123,360,0.3417,237,474,7.9,2.4,176
sub-2174_ses-T1,235,416,0.5649,181,362,6.033333333,2.4,177
sub-2175_ses-T1,552,679,0.813,127,254,4.233333333,2.4,178
sub-2176_ses-T1,136,360,0.3778,224,448,7.466666667,2.4,179
sub-2176_ses-T2,0,360,0,360,720,12,2.4,180
sub-2177_ses-T1,654,695,0.941,41,82,1.366666667,2.4,181
sub-2177_ses-T2,504,736,0.6848,232,464,7.733333333,2.4,182
sub-2178_ses-T2,151,360,0.4194,209,418,6.966666667,2.4,183
sub-2179_ses-T2,414,720,0.575,306,612,10.2,2.4,184
sub-2180_ses-T1,158,360,0.4389,202,404,6.733333333,2.4,185
sub-2180_ses-T2,54,360,0.15,306,612,10.2,2.4,186
sub-2181_ses-T1,298,360,0.8278,62,124,2.066666667,2.4,187
sub-2182_ses-T1,37,51,0.7255,14,28,0.466666667,2.4,188
sub-2184_ses-T1,300,391,0.7673,91,182,3.033333333,2.4,189
sub-2185_ses-T1,271,360,0.7528,89,178,2.966666667,2.4,190
sub-2186_ses-T1,110,371,0.2965,261,522,8.7,2.4,191
sub-2187_ses-T1,40,48,0.8333,8,16,0.266666667,2.4,192
sub-2188_ses-T1,386,445,0.8674,59,118,1.966666667,2.4,193
sub-2189_ses-T1,179,204,0.8775,25,50,0.833333333,2.4,194
sub-2190_ses-T1,192,360,0.5333,168,336,5.6,2.4,195
sub-2191_ses-T1,309,360,0.8583,51,102,1.7,2.4,196
sub-2191_ses-T2,5,360,0.0139,355,710,11.83333333,2.4,197
sub-2192_ses-T1,292,360,0.8111,68,136,2.266666667,2.4,198
sub-2193_ses-T2,480,625,0.768,145,290,4.833333333,2.4,199
sub-2194_ses-T1,308,415,0.7422,107,214,3.566666667,2.4,200
sub-2195_ses-T1,73,360,0.2028,287,574,9.566666667,2.4,201
sub-2196_ses-T1,141,416,0.3389,275,550,9.166666667,2.4,202
sub-2197_ses-T1,337,439,0.7677,102,204,3.4,2.4,203
sub-2197_ses-T2,155,384,0.4036,229,458,7.633333333,2.4,204
sub-2198_ses-T1,293,407,0.7199,114,228,3.8,2.4,205
sub-2199_ses-T1,292,404,0.7228,112,224,3.733333333,2.4,206
sub-2200_ses-T1,128,360,0.3556,232,464,7.733333333,2.4,207
sub-2201_ses-T1,280,360,0.7778,80,160,2.666666667,2.4,208
sub-2202_ses-T1,220,606,0.363,386,772,12.86666667,2.4,209
sub-2203_ses-T1,201,360,0.5583,159,318,5.3,2.4,210
sub-2204_ses-T1,257,360,0.7139,103,206,3.433333333,2.4,211
sub-2204_ses-T2,266,360,0.7389,94,188,3.133333333,2.4,212
sub-2205_ses-T1,213,360,0.5917,147,294,4.9,2.4,213
sub-2206_ses-T1,310,360,0.8611,50,100,1.666666667,2.4,214
sub-2206_ses-T2,298,720,0.4139,422,844,14.06666667,2.4,215
sub-2207_ses-T1,90,360,0.25,270,540,9,2.4,216
sub-2207_ses-T2,124,360,0.3444,236,472,7.866666667,2.4,217
sub-2208_ses-T1,290,360,0.8056,70,140,2.333333333,2.4,218
sub-2208_ses-T2,168,360,0.4667,192,384,6.4,2.4,219
sub-2209_ses-T1,256,341,0.7507,85,170,2.833333333,2.4,220
sub-2210_ses-T1,28,38,0.7368,10,20,0.333333333,2.4,221
sub-2211_ses-T1,279,360,0.775,81,162,2.7,2.4,222
sub-2212_ses-T1,292,360,0.8111,68,136,2.266666667,2.4,223
sub-2213_ses-T1,137,286,0.479,149,298,4.966666667,2.4,224
sub-2214_ses-T1,337,373,0.9035,36,72,1.2,2.4,225
sub-2215_ses-T1,306,360,0.85,54,108,1.8,2.4,226
sub-2216_ses-T1,30,86,0.3488,56,112,1.866666667,2.4,227
sub-2216_ses-T2,79,181,0.4365,102,204,3.4,2.4,228
sub-2217_ses-T1,111,360,0.3083,249,498,8.3,2.4,229
sub-2217_ses-T2,19,360,0.0528,341,682,11.36666667,2.4,230
sub-2218_ses-T1,193,360,0.5361,167,334,5.566666667,2.4,231
sub-2218_ses-T2,186,720,0.2583,534,1068,17.8,2.4,232
sub-2219_ses-T1,338,360,0.9389,22,44,0.733333333,2.4,233
sub-2220_ses-T1,311,360,0.8639,49,98,1.633333333,2.4,234
sub-2220_ses-T2,194,720,0.2694,526,1052,17.53333333,2.4,235
sub-2221_ses-T1,122,360,0.3389,238,476,7.933333333,2.4,236
sub-2221_ses-T2,352,720,0.4889,368,736,12.26666667,2.4,237
sub-2222_ses-T1,158,360,0.4389,202,404,6.733333333,2.4,238
sub-2223_ses-T1,248,360,0.6889,112,224,3.733333333,2.4,239
sub-2223_ses-T2,328,720,0.4556,392,784,13.06666667,2.4,240
sub-2224_ses-T1,188,379,0.496,191,382,6.366666667,2.4,241
sub-2225_ses-T1,286,360,0.7944,74,148,2.466666667,2.4,242
sub-2225_ses-T2,363,759,0.4783,396,792,13.2,2.4,243
sub-2226_ses-T1,112,365,0.3068,253,506,8.433333333,2.4,244
sub-2226_ses-T2,75,360,0.2083,285,570,9.5,2.4,245
sub-2227_ses-T1,255,360,0.7083,105,210,3.5,2.4,246
sub-2228_ses-T1,292,360,0.8111,68,136,2.266666667,2.4,247
sub-2228_ses-T2,369,729,0.5062,360,720,12,2.4,248
sub-2229_ses-T1,318,360,0.8833,42,84,1.4,2.4,249
sub-2229_ses-T2,118,390,0.3026,272,544,9.066666667,2.4,250
sub-2230_ses-T1,348,398,0.8744,50,100,1.666666667,2.4,251
sub-7001_ses-f2,217,720,0.3014,503,1006,16.76666667,2.4,252
sub-7001_ses-f3,63,720,0.0875,657,1314,21.9,2.4,253
sub-7002_ses-f1,295,720,0.4097,425,850,14.16666667,2.4,254
sub-7002_ses-f2,311,720,0.4319,409,818,13.63333333,2.4,255
sub-7003_ses-f1,161,360,0.4472,199,398,6.633333333,2.4,256
sub-7003_ses-f2,6,180,0.0333,174,348,5.8,2.4,257
sub-7004_ses-f3,320,724,0.442,404,808,13.46666667,2.4,258
sub-7006_ses-f1,44,52,0.8462,8,16,0.266666667,2.4,259
sub-7008_ses-f1,484,720,0.6722,236,472,7.866666667,2.4,260
sub-7008_ses-f2,117,720,0.1625,603,1206,20.1,2.4,261
sub-7009_ses-f1,361,720,0.5014,359,718,11.96666667,2.4,262
sub-7009_ses-f2,191,720,0.2653,529,1058,17.63333333,2.4,263
sub-7011_ses-f1,883,917,0.9629,34,68,1.133333333,2.4,264
sub-7011_ses-f2,142,360,0.3944,218,436,7.266666667,2.4,265
sub-7012_ses-f1,670,761,0.8804,91,182,3.033333333,2.4,266
sub-7012_ses-f2,430,720,0.5972,290,580,9.666666667,2.4,267
sub-7014_ses-f1,106,360,0.2944,254,508,8.466666667,2.4,268
sub-7014_ses-f2,392,720,0.5444,328,656,10.93333333,2.4,269
sub-7015_ses-f1,664,832,0.7981,168,336,5.6,2.4,270
sub-7015_ses-f2,327,729,0.4486,402,804,13.4,2.4,271
sub-7016_ses-f1,438,750,0.584,312,624,10.4,2.4,272
sub-7016_ses-f2,90,720,0.125,630,1260,21,2.4,273
sub-7017_ses-f1,714,740,0.9649,26,52,0.866666667,2.4,274
sub-7017_ses-f2,567,725,0.7821,158,316,5.266666667,2.4,275
sub-7020_ses-f1,242,740,0.327,498,996,16.6,2.4,276
sub-7020_ses-f2,190,720,0.2639,530,1060,17.66666667,2.4,277
sub-7021_ses-f1,683,753,0.907,70,140,2.333333333,2.4,278
sub-7022_ses-f1,641,720,0.8903,79,158,2.633333333,2.4,279
sub-7022_ses-f2,532,727,0.7318,195,390,6.5,2.4,280
sub-7023_ses-f1,488,744,0.6559,256,512,8.533333333,2.4,281
sub-7023_ses-f2,524,829,0.6321,305,610,10.16666667,2.4,282
sub-7024_ses-f1,604,728,0.8297,124,248,4.133333333,2.4,283
sub-7025_ses-f1,326,729,0.4472,403,806,13.43333333,2.4,284
sub-7025_ses-f2,179,760,0.2355,581,1162,19.36666667,2.4,285
sub-7026_ses-f1,596,920,0.6478,324,648,10.8,2.4,286
sub-7026_ses-f2,646,914,0.7068,268,536,8.933333333,2.4,287
sub-7026_ses-f3,113,731,0.1546,618,1236,20.6,2.4,288
sub-7027_ses-f1,838,885,0.9469,47,94,1.566666667,2.4,289
sub-7027_ses-f2,122,410,0.2976,288,576,9.6,2.4,290
sub-7027_ses-f3,146,725,0.2014,579,1158,19.3,2.4,291
sub-7028_ses-f1,727,752,0.9668,25,50,0.833333333,2.4,292
sub-7028_ses-f2,597,720,0.8292,123,246,4.1,2.4,293
sub-7029_ses-f1,440,731,0.6019,291,582,9.7,2.4,294
sub-7029_ses-f2,326,725,0.4497,399,798,13.3,2.4,295
sub-7030_ses-f1,487,720,0.6764,233,466,7.766666667,2.4,296
sub-7030_ses-f2,302,794,0.3804,492,984,16.4,2.4,297
sub-7031_ses-f1,14,192,0.0729,178,356,5.933333333,2.4,298
sub-7031_ses-f2,16,374,0.0428,358,716,11.93333333,2.4,299
sub-7031_ses-f3,396,737,0.5373,341,682,11.36666667,2.4,300
sub-7032_ses-f1,701,720,0.9736,19,38,0.633333333,2.4,301
sub-7032_ses-f2,52,73,0.7123,21,42,0.7,2.4,302
sub-7032_ses-f3,522,740,0.7054,218,436,7.266666667,2.4,303
sub-7033_ses-f2,309,752,0.4109,443,886,14.76666667,2.4,304
sub-7034_ses-f1,636,760,0.8368,124,248,4.133333333,2.4,305
sub-7034_ses-f2,537,912,0.5888,375,750,12.5,2.4,306
sub-7034_ses-f3,123,728,0.169,605,1210,20.16666667,2.4,307
sub-7035_ses-f1,11,50,0.22,39,78,1.3,2.4,308
sub-7035_ses-f2,130,727,0.1788,597,1194,19.9,2.4,309
sub-7036_ses-f1,256,745,0.3436,489,978,16.3,2.4,310
sub-7037_ses-f1,748,772,0.9689,24,48,0.8,2.4,311
sub-7037_ses-f2,738,852,0.8662,114,228,3.8,2.4,312
sub-7037_ses-f3,264,720,0.3667,456,912,15.2,2.4,313
sub-7038_ses-f1,510,789,0.6464,279,558,9.3,2.4,314
sub-7038_ses-f2,269,785,0.3427,516,1032,17.2,2.4,315
sub-7039_ses-f1,470,785,0.5987,315,630,10.5,2.4,316
sub-7039_ses-f2,299,727,0.4113,428,856,14.26666667,2.4,317
sub-7040_ses-f1,378,728,0.5192,350,700,11.66666667,2.4,318
sub-7040_ses-f2,237,720,0.3292,483,966,16.1,2.4,319
sub-7040_ses-f3,225,720,0.3125,495,990,16.5,2.4,320
sub-7041_ses-f1,610,754,0.809,144,288,4.8,2.4,321
sub-7041_ses-f2,224,735,0.3048,511,1022,17.03333333,2.4,322
sub-7042_ses-f3,301,658,0.4574,357,714,11.9,2.4,323
sub-7043_ses-f2,424,1080,0.3926,656,1312,21.86666667,2.4,324
sub-7044_ses-f2,411,739,0.5562,328,656,10.93333333,2.4,325
sub-7045_ses-f1,633,823,0.7691,190,380,6.333333333,2.4,326
sub-7046_ses-f1,545,812,0.6712,267,534,8.9,2.4,327
sub-7046_ses-f2,31,61,0.5082,30,60,1,2.4,328
sub-7046_ses-f3,197,741,0.2659,544,1088,18.13333333,2.4,329
sub-7047_ses-f1,545,720,0.7569,175,350,5.833333333,2.4,330
sub-7047_ses-f2,32,64,0.5,32,64,1.066666667,2.4,331
sub-7048_ses-f1,5,6,0.8333,1,2,0.033333333,2.4,332
sub-7048_ses-f2,181,360,0.5028,179,358,5.966666667,2.4,333
sub-7049_ses-f1,89,360,0.2472,271,542,9.033333333,2.4,334
sub-7052_ses-f1,145,518,0.2799,373,746,12.43333333,2.4,335
sub-7053_ses-f1,418,720,0.5806,302,604,10.06666667,2.4,336
sub-7054_ses-f1,549,766,0.7167,217,434,7.233333333,2.4,337
sub-2006_ses-T1,169,420,0.4024,251,502,8.366666667,2.6,1
sub-2011_ses-T1,136,360,0.3778,224,448,7.466666667,2.6,2
sub-2012_ses-T1,179,180,0.9944,1,2,0.033333333,2.6,3
sub-2013_ses-T1,179,360,0.4972,181,362,6.033333333,2.6,4
sub-2014_ses-T1,209,360,0.5806,151,302,5.033333333,2.6,5
sub-2015_ses-T1,17,180,0.0944,163,326,5.433333333,2.6,6
sub-2016_ses-T1,184,360,0.5111,176,352,5.866666667,2.6,7
sub-2017_ses-T1,154,180,0.8556,26,52,0.866666667,2.6,8
sub-2018_ses-T1,64,180,0.3556,116,232,3.866666667,2.6,9
sub-2019_ses-T1,256,360,0.7111,104,208,3.466666667,2.6,10
sub-2020_ses-T1,17,26,0.6538,9,18,0.3,2.6,11
sub-2020_ses-T2,134,360,0.3722,226,452,7.533333333,2.6,12
sub-2021_ses-T1,143,360,0.3972,217,434,7.233333333,2.6,13
sub-2022_ses-T1,181,360,0.5028,179,358,5.966666667,2.6,14
sub-2023_ses-T1,102,360,0.2833,258,516,8.6,2.6,15
sub-2024_ses-T2,5,12,0.4167,7,14,0.233333333,2.6,16
sub-2026_ses-T1,114,223,0.5112,109,218,3.633333333,2.6,17
sub-2027_ses-T1,288,360,0.8,72,144,2.4,2.6,18
sub-2028_ses-T1,143,360,0.3972,217,434,7.233333333,2.6,19
sub-2029_ses-T1,202,360,0.5611,158,316,5.266666667,2.6,20
sub-2030_ses-T1,77,360,0.2139,283,566,9.433333333,2.6,21
sub-2031_ses-T1,348,360,0.9667,12,24,0.4,2.6,22
sub-2032_ses-T1,79,360,0.2194,281,562,9.366666667,2.6,23
sub-2033_ses-T1,306,360,0.85,54,108,1.8,2.6,24
sub-2033_ses-T2,108,360,0.3,252,504,8.4,2.6,25
sub-2034_ses-T1,9,180,0.05,171,342,5.7,2.6,26
sub-2035_ses-T1,310,360,0.8611,50,100,1.666666667,2.6,27
sub-2036_ses-T1,245,360,0.6806,115,230,3.833333333,2.6,28
sub-2037_ses-T1,217,360,0.6028,143,286,4.766666667,2.6,29
sub-2038_ses-T1,326,360,0.9056,34,68,1.133333333,2.6,30
sub-2039_ses-T1,176,180,0.9778,4,8,0.133333333,2.6,31
sub-2040_ses-T1,271,360,0.7528,89,178,2.966666667,2.6,32
sub-2041_ses-T1,258,360,0.7167,102,204,3.4,2.6,33
sub-2042_ses-T1,41,180,0.2278,139,278,4.633333333,2.6,34
sub-2043_ses-T1,78,360,0.2167,282,564,9.4,2.6,35
sub-2044_ses-T1,119,360,0.3306,241,482,8.033333333,2.6,36
sub-2045_ses-T1,23,180,0.1278,157,314,5.233333333,2.6,37
sub-2046_ses-T1,121,180,0.6722,59,118,1.966666667,2.6,38
sub-2047_ses-T1,53,180,0.2944,127,254,4.233333333,2.6,39
sub-2048_ses-T1,143,180,0.7944,37,74,1.233333333,2.6,40
sub-2049_ses-T1,236,360,0.6556,124,248,4.133333333,2.6,41
sub-2051_ses-T1,326,360,0.9056,34,68,1.133333333,2.6,42
sub-2051_ses-T2,329,360,0.9139,31,62,1.033333333,2.6,43
sub-2052_ses-T1,185,360,0.5139,175,350,5.833333333,2.6,44
sub-2052_ses-T2,38,180,0.2111,142,284,4.733333333,2.6,45
sub-2053_ses-T1,116,360,0.3222,244,488,8.133333333,2.6,46
sub-2055_ses-T1,41,180,0.2278,139,278,4.633333333,2.6,47
sub-2056_ses-T1,349,360,0.9694,11,22,0.366666667,2.6,48
sub-2057_ses-T1,243,360,0.675,117,234,3.9,2.6,49
sub-2058_ses-T1,200,360,0.5556,160,320,5.333333333,2.6,50
sub-2059_ses-T1,193,360,0.5361,167,334,5.566666667,2.6,51
sub-2061_ses-T1,53,180,0.2944,127,254,4.233333333,2.6,52
sub-2062_ses-T1,303,360,0.8417,57,114,1.9,2.6,53
sub-2063_ses-T1,145,360,0.4028,215,430,7.166666667,2.6,54
sub-2064_ses-T1,111,180,0.6167,69,138,2.3,2.6,55
sub-2065_ses-T1,21,180,0.1167,159,318,5.3,2.6,56
sub-2066_ses-T1,118,180,0.6556,62,124,2.066666667,2.6,57
sub-2066_ses-T2,206,360,0.5722,154,308,5.133333333,2.6,58
sub-2067_ses-T1,211,360,0.5861,149,298,4.966666667,2.6,59
sub-2068_ses-T1,256,360,0.7111,104,208,3.466666667,2.6,60
sub-2069_ses-T1,98,360,0.2722,262,524,8.733333333,2.6,61
sub-2070_ses-T1,225,360,0.625,135,270,4.5,2.6,62
sub-2071_ses-T1,238,360,0.6611,122,244,4.066666667,2.6,63
sub-2072_ses-T1,272,360,0.7556,88,176,2.933333333,2.6,64
sub-2073_ses-T1,237,256,0.9258,19,38,0.633333333,2.6,65
sub-2073_ses-T2,72,180,0.4,108,216,3.6,2.6,66
sub-2074_ses-T1,21,180,0.1167,159,318,5.3,2.6,67
sub-2075_ses-T1,132,180,0.7333,48,96,1.6,2.6,68
sub-2076_ses-T1,131,360,0.3639,229,458,7.633333333,2.6,69
sub-2076_ses-T2,53,360,0.1472,307,614,10.23333333,2.6,70
sub-2077_ses-T1,308,360,0.8556,52,104,1.733333333,2.6,71
sub-2078_ses-T1,260,360,0.7222,100,200,3.333333333,2.6,72
sub-2079_ses-T1,211,360,0.5861,149,298,4.966666667,2.6,73
sub-2079_ses-T2,89,360,0.2472,271,542,9.033333333,2.6,74
sub-2080_ses-T1,105,360,0.2917,255,510,8.5,2.6,75
sub-2081_ses-T1,256,360,0.7111,104,208,3.466666667,2.6,76
sub-2082_ses-T1,145,360,0.4028,215,430,7.166666667,2.6,77
sub-2083_ses-T1,94,360,0.2611,266,532,8.866666667,2.6,78
sub-2084_ses-T1,338,360,0.9389,22,44,0.733333333,2.6,79
sub-2085_ses-T1,171,360,0.475,189,378,6.3,2.6,80
sub-2086_ses-T1,48,360,0.1333,312,624,10.4,2.6,81
sub-2087_ses-T1,330,360,0.9167,30,60,1,2.6,82
sub-2088_ses-T1,233,360,0.6472,127,254,4.233333333,2.6,83
sub-2089_ses-T1,162,180,0.9,18,36,0.6,2.6,84
sub-2091_ses-T1,97,360,0.2694,263,526,8.766666667,2.6,85
sub-2092_ses-T1,230,360,0.6389,130,260,4.333333333,2.6,86
sub-2093_ses-T1,244,360,0.6778,116,232,3.866666667,2.6,87
sub-2094_ses-T1,168,180,0.9333,12,24,0.4,2.6,88
sub-2095_ses-T1,271,360,0.7528,89,178,2.966666667,2.6,89
sub-2096_ses-T1,219,360,0.6083,141,282,4.7,2.6,90
sub-2097_ses-T1,397,540,0.7352,143,286,4.766666667,2.6,91
sub-2098_ses-T1,70,360,0.1944,290,580,9.666666667,2.6,92
sub-2099_ses-T1,88,180,0.4889,92,184,3.066666667,2.6,93
sub-2099_ses-T2,118,360,0.3278,242,484,8.066666667,2.6,94
sub-2100_ses-T1,110,180,0.6111,70,140,2.333333333,2.6,95
sub-2100_ses-T2,104,360,0.2889,256,512,8.533333333,2.6,96
sub-2101_ses-T1,208,360,0.5778,152,304,5.066666667,2.6,97
sub-2101_ses-T2,131,360,0.3639,229,458,7.633333333,2.6,98
sub-2102_ses-T1,261,360,0.725,99,198,3.3,2.6,99
sub-2103_ses-T1,176,360,0.4889,184,368,6.133333333,2.6,100
sub-2103_ses-T2,287,360,0.7972,73,146,2.433333333,2.6,101
sub-2104_ses-T1,307,387,0.7933,80,160,2.666666667,2.6,102
sub-2105_ses-T1,267,360,0.7417,93,186,3.1,2.6,103
sub-2105_ses-T2,270,360,0.75,90,180,3,2.6,104
sub-2106_ses-T1,293,360,0.8139,67,134,2.233333333,2.6,105
sub-2107_ses-T1,124,360,0.3444,236,472,7.866666667,2.6,106
sub-2107_ses-T2,163,360,0.4528,197,394,6.566666667,2.6,107
sub-2108_ses-T1,333,360,0.925,27,54,0.9,2.6,108
sub-2108_ses-T3,108,141,0.766,33,66,1.1,2.6,109
sub-2109_ses-T1,95,180,0.5278,85,170,2.833333333,2.6,110
sub-2110_ses-T1,224,274,0.8175,50,100,1.666666667,2.6,111
sub-2115_ses-T1,252,360,0.7,108,216,3.6,2.6,112
sub-2115_ses-T2,168,360,0.4667,192,384,6.4,2.6,113
sub-2117_ses-T1,243,360,0.675,117,234,3.9,2.6,114
sub-2117_ses-T2,87,360,0.2417,273,546,9.1,2.6,115
sub-2118_ses-T1,164,360,0.4556,196,392,6.533333333,2.6,116
sub-2120_ses-T1,220,360,0.6111,140,280,4.666666667,2.6,117
sub-2122_ses-T1,212,360,0.5889,148,296,4.933333333,2.6,118
sub-2123_ses-T1,324,360,0.9,36,72,1.2,2.6,119
sub-2124_ses-T1,339,404,0.8391,65,130,2.166666667,2.6,120
sub-2126_ses-T1,245,360,0.6806,115,230,3.833333333,2.6,121
sub-2128_ses-T1,260,360,0.7222,100,200,3.333333333,2.6,122
sub-2133_ses-T1,181,360,0.5028,179,358,5.966666667,2.6,123
sub-2135_ses-T1,7,19,0.3684,12,24,0.4,2.6,124
sub-2136_ses-T1,362,720,0.5028,358,716,11.93333333,2.6,125
sub-2137_ses-T1,316,720,0.4389,404,808,13.46666667,2.6,126
sub-2137_ses-T2,110,360,0.3056,250,500,8.333333333,2.6,127
sub-2138_ses-T1,292,360,0.8111,68,136,2.266666667,2.6,128
sub-2139_ses-T1,92,360,0.2556,268,536,8.933333333,2.6,129
sub-2140_ses-T1,377,379,0.9947,2,4,0.066666667,2.6,130
sub-2141_ses-T1,157,360,0.4361,203,406,6.766666667,2.6,131
sub-2142_ses-T2,306,360,0.85,54,108,1.8,2.6,132
sub-2143_ses-T1,191,360,0.5306,169,338,5.633333333,2.6,133
sub-2144_ses-T1,213,372,0.5726,159,318,5.3,2.6,134
sub-2145_ses-T1,207,360,0.575,153,306,5.1,2.6,135
sub-2145_ses-T2,55,360,0.1528,305,610,10.16666667,2.6,136
sub-2146_ses-T1,305,360,0.8472,55,110,1.833333333,2.6,137
sub-2146_ses-T2,330,720,0.4583,390,780,13,2.6,138
sub-2147_ses-T1,205,360,0.5694,155,310,5.166666667,2.6,139
sub-2147_ses-T2,225,360,0.625,135,270,4.5,2.6,140
sub-2148_ses-T1,344,399,0.8622,55,110,1.833333333,2.6,141
sub-2149_ses-T1,223,360,0.6194,137,274,4.566666667,2.6,142
sub-2150_ses-T1,318,360,0.8833,42,84,1.4,2.6,143
sub-2150_ses-T2,197,360,0.5472,163,326,5.433333333,2.6,144
sub-2151_ses-T1,352,720,0.4889,368,736,12.26666667,2.6,145
sub-2151_ses-T2,431,773,0.5576,342,684,11.4,2.6,146
sub-2152_ses-T1,329,360,0.9139,31,62,1.033333333,2.6,147
sub-2152_ses-T2,159,360,0.4417,201,402,6.7,2.6,148
sub-2153_ses-T1,323,383,0.8433,60,120,2,2.6,149
sub-2154_ses-T2,303,360,0.8417,57,114,1.9,2.6,150
sub-2155_ses-T1,203,360,0.5639,157,314,5.233333333,2.6,151
sub-2156_ses-T1,146,360,0.4056,214,428,7.133333333,2.6,152
sub-2157_ses-T1,282,360,0.7833,78,156,2.6,2.6,153
sub-2158_ses-T1,231,360,0.6417,129,258,4.3,2.6,154
sub-2159_ses-T1,158,360,0.4389,202,404,6.733333333,2.6,155
sub-2160_ses-T1,117,360,0.325,243,486,8.1,2.6,156
sub-2161_ses-T1,237,360,0.6583,123,246,4.1,2.6,157
sub-2162_ses-T1,270,360,0.75,90,180,3,2.6,158
sub-2163_ses-T1,310,399,0.7769,89,178,2.966666667,2.6,159
sub-2164_ses-T1,176,720,0.2444,544,1088,18.13333333,2.6,160
sub-2164_ses-T2,393,720,0.5458,327,654,10.9,2.6,161
sub-2165_ses-T1,231,481,0.4802,250,500,8.333333333,2.6,162
sub-2166_ses-T1,237,360,0.6583,123,246,4.1,2.6,163
sub-2166_ses-T2,176,360,0.4889,184,368,6.133333333,2.6,164
sub-2167_ses-T1,300,370,0.8108,70,140,2.333333333,2.6,165
sub-2168_ses-T1,278,360,0.7722,82,164,2.733333333,2.6,166
sub-2168_ses-T2,227,360,0.6306,133,266,4.433333333,2.6,167
sub-2169_ses-T1,280,360,0.7778,80,160,2.666666667,2.6,168
sub-2169_ses-T2,163,360,0.4528,197,394,6.566666667,2.6,169
sub-2170_ses-T1,134,264,0.5076,130,260,4.333333333,2.6,170
sub-2171_ses-T1,288,374,0.7701,86,172,2.866666667,2.6,171
sub-2171_ses-T2,217,483,0.4493,266,532,8.866666667,2.6,172
sub-2171_ses-T3,167,577,0.2894,410,820,13.66666667,2.6,173
sub-2172_ses-T1,232,513,0.4522,281,562,9.366666667,2.6,174
sub-2172_ses-T2,296,386,0.7668,90,180,3,2.6,175
sub-2173_ses-T1,114,360,0.3167,246,492,8.2,2.6,176
sub-2174_ses-T1,218,416,0.524,198,396,6.6,2.6,177
sub-2175_ses-T1,534,679,0.7865,145,290,4.833333333,2.6,178
sub-2176_ses-T1,132,360,0.3667,228,456,7.6,2.6,179
sub-2176_ses-T2,0,360,0,360,720,12,2.6,180
sub-2177_ses-T1,643,695,0.9252,52,104,1.733333333,2.6,181
sub-2177_ses-T2,454,736,0.6168,282,564,9.4,2.6,182
sub-2178_ses-T2,131,360,0.3639,229,458,7.633333333,2.6,183
sub-2179_ses-T2,380,720,0.5278,340,680,11.33333333,2.6,184
sub-2180_ses-T1,148,360,0.4111,212,424,7.066666667,2.6,185
sub-2180_ses-T2,51,360,0.1417,309,618,10.3,2.6,186
sub-2181_ses-T1,289,360,0.8028,71,142,2.366666667,2.6,187
sub-2182_ses-T1,34,51,0.6667,17,34,0.566666667,2.6,188
sub-2184_ses-T1,285,391,0.7289,106,212,3.533333333,2.6,189
sub-2185_ses-T1,258,360,0.7167,102,204,3.4,2.6,190
sub-2186_ses-T1,92,371,0.248,279,558,9.3,2.6,191
sub-2187_ses-T1,40,48,0.8333,8,16,0.266666667,2.6,192
sub-2188_ses-T1,377,445,0.8472,68,136,2.266666667,2.6,193
sub-2189_ses-T1,177,204,0.8676,27,54,0.9,2.6,194
sub-2190_ses-T1,187,360,0.5194,173,346,5.766666667,2.6,195
sub-2191_ses-T1,291,360,0.8083,69,138,2.3,2.6,196
sub-2191_ses-T2,2,360,0.0056,358,716,11.93333333,2.6,197
sub-2192_ses-T1,274,360,0.7611,86,172,2.866666667,2.6,198
sub-2193_ses-T2,471,625,0.7536,154,308,5.133333333,2.6,199
sub-2194_ses-T1,293,415,0.706,122,244,4.066666667,2.6,200
sub-2195_ses-T1,66,360,0.1833,294,588,9.8,2.6,201
sub-2196_ses-T1,122,416,0.2933,294,588,9.8,2.6,202
sub-2197_ses-T1,328,439,0.7472,111,222,3.7,2.6,203
sub-2197_ses-T2,135,384,0.3516,249,498,8.3,2.6,204
sub-2198_ses-T1,285,407,0.7002,122,244,4.066666667,2.6,205
sub-2199_ses-T1,280,404,0.6931,124,248,4.133333333,2.6,206
sub-2200_ses-T1,125,360,0.3472,235,470,7.833333333,2.6,207
sub-2201_ses-T1,267,360,0.7417,93,186,3.1,2.6,208
sub-2202_ses-T1,194,606,0.3201,412,824,13.73333333,2.6,209
sub-2203_ses-T1,181,360,0.5028,179,358,5.966666667,2.6,210
sub-2204_ses-T1,247,360,0.6861,113,226,3.766666667,2.6,211
sub-2204_ses-T2,256,360,0.7111,104,208,3.466666667,2.6,212
sub-2205_ses-T1,199,360,0.5528,161,322,5.366666667,2.6,213
sub-2206_ses-T1,300,360,0.8333,60,120,2,2.6,214
sub-2206_ses-T2,276,720,0.3833,444,888,14.8,2.6,215
sub-2207_ses-T1,77,360,0.2139,283,566,9.433333333,2.6,216
sub-2207_ses-T2,105,360,0.2917,255,510,8.5,2.6,217
sub-2208_ses-T1,277,360,0.7694,83,166,2.766666667,2.6,218
sub-2208_ses-T2,157,360,0.4361,203,406,6.766666667,2.6,219
sub-2209_ses-T1,241,341,0.7067,100,200,3.333333333,2.6,220
sub-2210_ses-T1,27,38,0.7105,11,22,0.366666667,2.6,221
sub-2211_ses-T1,265,360,0.7361,95,190,3.166666667,2.6,222
sub-2212_ses-T1,286,360,0.7944,74,148,2.466666667,2.6,223
sub-2213_ses-T1,130,286,0.4545,156,312,5.2,2.6,224
sub-2214_ses-T1,332,373,0.8901,41,82,1.366666667,2.6,225
sub-2215_ses-T1,292,360,0.8111,68,136,2.266666667,2.6,226
sub-2216_ses-T1,27,86,0.314,59,118,1.966666667,2.6,227
sub-2216_ses-T2,76,181,0.4199,105,210,3.5,2.6,228
sub-2217_ses-T1,95,360,0.2639,265,530,8.833333333,2.6,229
sub-2217_ses-T2,19,360,0.0528,341,682,11.36666667,2.6,230
sub-2218_ses-T1,178,360,0.4944,182,364,6.066666667,2.6,231
sub-2218_ses-T2,174,720,0.2417,546,1092,18.2,2.6,232
sub-2219_ses-T1,330,360,0.9167,30,60,1,2.6,233
sub-2220_ses-T1,300,360,0.8333,60,120,2,2.6,234
sub-2220_ses-T2,130,720,0.1806,590,1180,19.66666667,2.6,235
sub-2221_ses-T1,111,360,0.3083,249,498,8.3,2.6,236
sub-2221_ses-T2,332,720,0.4611,388,776,12.93333333,2.6,237
sub-2222_ses-T1,144,360,0.4,216,432,7.2,2.6,238
sub-2223_ses-T1,236,360,0.6556,124,248,4.133333333,2.6,239
sub-2223_ses-T2,304,720,0.4222,416,832,13.86666667,2.6,240
sub-2224_ses-T1,176,379,0.4644,203,406,6.766666667,2.6,241
sub-2225_ses-T1,269,360,0.7472,91,182,3.033333333,2.6,242
sub-2225_ses-T2,320,759,0.4216,439,878,14.63333333,2.6,243
sub-2226_ses-T1,102,365,0.2795,263,526,8.766666667,2.6,244
sub-2226_ses-T2,63,360,0.175,297,594,9.9,2.6,245
sub-2227_ses-T1,240,360,0.6667,120,240,4,2.6,246
sub-2228_ses-T1,280,360,0.7778,80,160,2.666666667,2.6,247
sub-2228_ses-T2,340,729,0.4664,389,778,12.96666667,2.6,248
sub-2229_ses-T1,315,360,0.875,45,90,1.5,2.6,249
sub-2229_ses-T2,100,390,0.2564,290,580,9.666666667,2.6,250
sub-2230_ses-T1,344,398,0.8643,54,108,1.8,2.6,251
sub-7001_ses-f2,206,720,0.2861,514,1028,17.13333333,2.6,252
sub-7001_ses-f3,58,720,0.0806,662,1324,22.06666667,2.6,253
sub-7002_ses-f1,256,720,0.3556,464,928,15.46666667,2.6,254
sub-7002_ses-f2,298,720,0.4139,422,844,14.06666667,2.6,255
sub-7003_ses-f1,133,360,0.3694,227,454,7.566666667,2.6,256
sub-7003_ses-f2,5,180,0.0278,175,350,5.833333333,2.6,257
sub-7004_ses-f3,308,724,0.4254,416,832,13.86666667,2.6,258
sub-7006_ses-f1,40,52,0.7692,12,24,0.4,2.6,259
sub-7008_ses-f1,460,720,0.6389,260,520,8.666666667,2.6,260
sub-7008_ses-f2,105,720,0.1458,615,1230,20.5,2.6,261
sub-7009_ses-f1,344,720,0.4778,376,752,12.53333333,2.6,262
sub-7009_ses-f2,185,720,0.2569,535,1070,17.83333333,2.6,263
sub-7011_ses-f1,872,917,0.9509,45,90,1.5,2.6,264
sub-7011_ses-f2,125,360,0.3472,235,470,7.833333333,2.6,265
sub-7012_ses-f1,659,761,0.866,102,204,3.4,2.6,266
sub-7012_ses-f2,406,720,0.5639,314,628,10.46666667,2.6,267
sub-7014_ses-f1,91,360,0.2528,269,538,8.966666667,2.6,268
sub-7014_ses-f2,351,720,0.4875,369,738,12.3,2.6,269
sub-7015_ses-f1,651,832,0.7825,181,362,6.033333333,2.6,270
sub-7015_ses-f2,308,729,0.4225,421,842,14.03333333,2.6,271
sub-7016_ses-f1,417,750,0.556,333,666,11.1,2.6,272
sub-7016_ses-f2,85,720,0.1181,635,1270,21.16666667,2.6,273
sub-7017_ses-f1,700,740,0.9459,40,80,1.333333333,2.6,274
sub-7017_ses-f2,527,725,0.7269,198,396,6.6,2.6,275
sub-7020_ses-f1,214,740,0.2892,526,1052,17.53333333,2.6,276
sub-7020_ses-f2,177,720,0.2458,543,1086,18.1,2.6,277
sub-7021_ses-f1,674,753,0.8951,79,158,2.633333333,2.6,278
sub-7022_ses-f1,618,720,0.8583,102,204,3.4,2.6,279
sub-7022_ses-f2,481,727,0.6616,246,492,8.2,2.6,280
sub-7023_ses-f1,464,744,0.6237,280,560,9.333333333,2.6,281
sub-7023_ses-f2,500,829,0.6031,329,658,10.96666667,2.6,282
sub-7024_ses-f1,581,728,0.7981,147,294,4.9,2.6,283
sub-7025_ses-f1,296,729,0.406,433,866,14.43333333,2.6,284
sub-7025_ses-f2,168,760,0.2211,592,1184,19.73333333,2.6,285
sub-7026_ses-f1,568,920,0.6174,352,704,11.73333333,2.6,286
sub-7026_ses-f2,607,914,0.6641,307,614,10.23333333,2.6,287
sub-7026_ses-f3,105,731,0.1436,626,1252,20.86666667,2.6,288
sub-7027_ses-f1,820,885,0.9266,65,130,2.166666667,2.6,289
sub-7027_ses-f2,115,410,0.2805,295,590,9.833333333,2.6,290
sub-7027_ses-f3,116,725,0.16,609,1218,20.3,2.6,291
sub-7028_ses-f1,719,752,0.9561,33,66,1.1,2.6,292
sub-7028_ses-f2,576,720,0.8,144,288,4.8,2.6,293
sub-7029_ses-f1,405,731,0.554,326,652,10.86666667,2.6,294
sub-7029_ses-f2,292,725,0.4028,433,866,14.43333333,2.6,295
sub-7030_ses-f1,472,720,0.6556,248,496,8.266666667,2.6,296
sub-7030_ses-f2,281,794,0.3539,513,1026,17.1,2.6,297
sub-7031_ses-f1,13,192,0.0677,179,358,5.966666667,2.6,298
sub-7031_ses-f2,13,374,0.0348,361,722,12.03333333,2.6,299
sub-7031_ses-f3,356,737,0.483,381,762,12.7,2.6,300
sub-7032_ses-f1,698,720,0.9694,22,44,0.733333333,2.6,301
sub-7032_ses-f2,49,73,0.6712,24,48,0.8,2.6,302
sub-7032_ses-f3,498,740,0.673,242,484,8.066666667,2.6,303
sub-7033_ses-f2,293,752,0.3896,459,918,15.3,2.6,304
sub-7034_ses-f1,621,760,0.8171,139,278,4.633333333,2.6,305
sub-7034_ses-f2,515,912,0.5647,397,794,13.23333333,2.6,306
sub-7034_ses-f3,112,728,0.1538,616,1232,20.53333333,2.6,307
sub-7035_ses-f1,11,50,0.22,39,78,1.3,2.6,308
sub-7035_ses-f2,120,727,0.1651,607,1214,20.23333333,2.6,309
sub-7036_ses-f1,238,745,0.3195,507,1014,16.9,2.6,310
sub-7037_ses-f1,745,772,0.965,27,54,0.9,2.6,311
sub-7037_ses-f2,719,852,0.8439,133,266,4.433333333,2.6,312
sub-7037_ses-f3,223,720,0.3097,497,994,16.56666667,2.6,313
sub-7038_ses-f1,495,789,0.6274,294,588,9.8,2.6,314
sub-7038_ses-f2,259,785,0.3299,526,1052,17.53333333,2.6,315
sub-7039_ses-f1,444,785,0.5656,341,682,11.36666667,2.6,316
sub-7039_ses-f2,260,727,0.3576,467,934,15.56666667,2.6,317
sub-7040_ses-f1,362,728,0.4973,366,732,12.2,2.6,318
sub-7040_ses-f2,208,720,0.2889,512,1024,17.06666667,2.6,319
sub-7040_ses-f3,202,720,0.2806,518,1036,17.26666667,2.6,320
sub-7041_ses-f1,582,754,0.7719,172,344,5.733333333,2.6,321
sub-7041_ses-f2,212,735,0.2884,523,1046,17.43333333,2.6,322
sub-7042_ses-f3,278,658,0.4225,380,760,12.66666667,2.6,323
sub-7043_ses-f2,390,1080,0.3611,690,1380,23,2.6,324
sub-7044_ses-f2,390,739,0.5277,349,698,11.63333333,2.6,325
sub-7045_ses-f1,604,823,0.7339,219,438,7.3,2.6,326
sub-7046_ses-f1,506,812,0.6232,306,612,10.2,2.6,327
sub-7046_ses-f2,31,61,0.5082,30,60,1,2.6,328
sub-7046_ses-f3,149,741,0.2011,592,1184,19.73333333,2.6,329
sub-7047_ses-f1,508,720,0.7056,212,424,7.066666667,2.6,330
sub-7047_ses-f2,32,64,0.5,32,64,1.066666667,2.6,331
sub-7048_ses-f1,5,6,0.8333,1,2,0.033333333,2.6,332
sub-7048_ses-f2,168,360,0.4667,192,384,6.4,2.6,333
sub-7049_ses-f1,81,360,0.225,279,558,9.3,2.6,334
sub-7052_ses-f1,118,518,0.2278,400,800,13.33333333,2.6,335
sub-7053_ses-f1,386,720,0.5361,334,668,11.13333333,2.6,336
sub-7054_ses-f1,530,766,0.6919,236,472,7.866666667,2.6,337
sub-2006_ses-T1,155,420,0.369,265,530,8.833333333,2.8,1
sub-2011_ses-T1,129,360,0.3583,231,462,7.7,2.8,2
sub-2012_ses-T1,179,180,0.9944,1,2,0.033333333,2.8,3
sub-2013_ses-T1,170,360,0.4722,190,380,6.333333333,2.8,4
sub-2014_ses-T1,193,360,0.5361,167,334,5.566666667,2.8,5
sub-2015_ses-T1,14,180,0.0778,166,332,5.533333333,2.8,6
sub-2016_ses-T1,167,360,0.4639,193,386,6.433333333,2.8,7
sub-2017_ses-T1,146,180,0.8111,34,68,1.133333333,2.8,8
sub-2018_ses-T1,55,180,0.3056,125,250,4.166666667,2.8,9
sub-2019_ses-T1,247,360,0.6861,113,226,3.766666667,2.8,10
sub-2020_ses-T1,17,26,0.6538,9,18,0.3,2.8,11
sub-2020_ses-T2,124,360,0.3444,236,472,7.866666667,2.8,12
sub-2021_ses-T1,127,360,0.3528,233,466,7.766666667,2.8,13
sub-2022_ses-T1,178,360,0.4944,182,364,6.066666667,2.8,14
sub-2023_ses-T1,96,360,0.2667,264,528,8.8,2.8,15
sub-2024_ses-T2,4,12,0.3333,8,16,0.266666667,2.8,16
sub-2026_ses-T1,103,223,0.4619,120,240,4,2.8,17
sub-2027_ses-T1,282,360,0.7833,78,156,2.6,2.8,18
sub-2028_ses-T1,131,360,0.3639,229,458,7.633333333,2.8,19
sub-2029_ses-T1,180,360,0.5,180,360,6,2.8,20
sub-2030_ses-T1,74,360,0.2056,286,572,9.533333333,2.8,21
sub-2031_ses-T1,344,360,0.9556,16,32,0.533333333,2.8,22
sub-2032_ses-T1,73,360,0.2028,287,574,9.566666667,2.8,23
sub-2033_ses-T1,300,360,0.8333,60,120,2,2.8,24
sub-2033_ses-T2,103,360,0.2861,257,514,8.566666667,2.8,25
sub-2034_ses-T1,8,180,0.0444,172,344,5.733333333,2.8,26
sub-2035_ses-T1,300,360,0.8333,60,120,2,2.8,27
sub-2036_ses-T1,227,360,0.6306,133,266,4.433333333,2.8,28
sub-2037_ses-T1,202,360,0.5611,158,316,5.266666667,2.8,29
sub-2038_ses-T1,318,360,0.8833,42,84,1.4,2.8,30
sub-2039_ses-T1,176,180,0.9778,4,8,0.133333333,2.8,31
sub-2040_ses-T1,263,360,0.7306,97,194,3.233333333,2.8,32
sub-2041_ses-T1,244,360,0.6778,116,232,3.866666667,2.8,33
sub-2042_ses-T1,36,180,0.2,144,288,4.8,2.8,34
sub-2043_ses-T1,75,360,0.2083,285,570,9.5,2.8,35
sub-2044_ses-T1,110,360,0.3056,250,500,8.333333333,2.8,36
sub-2045_ses-T1,15,180,0.0833,165,330,5.5,2.8,37
sub-2046_ses-T1,112,180,0.6222,68,136,2.266666667,2.8,38
sub-2047_ses-T1,47,180,0.2611,133,266,4.433333333,2.8,39
sub-2048_ses-T1,137,180,0.7611,43,86,1.433333333,2.8,40
sub-2049_ses-T1,224,360,0.6222,136,272,4.533333333,2.8,41
sub-2051_ses-T1,318,360,0.8833,42,84,1.4,2.8,42
sub-2051_ses-T2,321,360,0.8917,39,78,1.3,2.8,43
sub-2052_ses-T1,170,360,0.4722,190,380,6.333333333,2.8,44
sub-2052_ses-T2,34,180,0.1889,146,292,4.866666667,2.8,45
sub-2053_ses-T1,113,360,0.3139,247,494,8.233333333,2.8,46
sub-2055_ses-T1,40,180,0.2222,140,280,4.666666667,2.8,47
sub-2056_ses-T1,348,360,0.9667,12,24,0.4,2.8,48
sub-2057_ses-T1,221,360,0.6139,139,278,4.633333333,2.8,49
sub-2058_ses-T1,196,360,0.5444,164,328,5.466666667,2.8,50
sub-2059_ses-T1,190,360,0.5278,170,340,5.666666667,2.8,51
sub-2061_ses-T1,47,180,0.2611,133,266,4.433333333,2.8,52
sub-2062_ses-T1,296,360,0.8222,64,128,2.133333333,2.8,53
sub-2063_ses-T1,134,360,0.3722,226,452,7.533333333,2.8,54
sub-2064_ses-T1,99,180,0.55,81,162,2.7,2.8,55
sub-2065_ses-T1,9,180,0.05,171,342,5.7,2.8,56
sub-2066_ses-T1,111,180,0.6167,69,138,2.3,2.8,57
sub-2066_ses-T2,193,360,0.5361,167,334,5.566666667,2.8,58
sub-2067_ses-T1,191,360,0.5306,169,338,5.633333333,2.8,59
sub-2068_ses-T1,245,360,0.6806,115,230,3.833333333,2.8,60
sub-2069_ses-T1,85,360,0.2361,275,550,9.166666667,2.8,61
sub-2070_ses-T1,213,360,0.5917,147,294,4.9,2.8,62
sub-2071_ses-T1,221,360,0.6139,139,278,4.633333333,2.8,63
sub-2072_ses-T1,263,360,0.7306,97,194,3.233333333,2.8,64
sub-2073_ses-T1,236,256,0.9219,20,40,0.666666667,2.8,65
sub-2073_ses-T2,65,180,0.3611,115,230,3.833333333,2.8,66
sub-2074_ses-T1,17,180,0.0944,163,326,5.433333333,2.8,67
sub-2075_ses-T1,125,180,0.6944,55,110,1.833333333,2.8,68
sub-2076_ses-T1,123,360,0.3417,237,474,7.9,2.8,69
sub-2076_ses-T2,50,360,0.1389,310,620,10.33333333,2.8,70
sub-2077_ses-T1,296,360,0.8222,64,128,2.133333333,2.8,71
sub-2078_ses-T1,243,360,0.675,117,234,3.9,2.8,72
sub-2079_ses-T1,205,360,0.5694,155,310,5.166666667,2.8,73
sub-2079_ses-T2,83,360,0.2306,277,554,9.233333333,2.8,74
sub-2080_ses-T1,98,360,0.2722,262,524,8.733333333,2.8,75
sub-2081_ses-T1,244,360,0.6778,116,232,3.866666667,2.8,76
sub-2082_ses-T1,136,360,0.3778,224,448,7.466666667,2.8,77
sub-2083_ses-T1,94,360,0.2611,266,532,8.866666667,2.8,78
sub-2084_ses-T1,332,360,0.9222,28,56,0.933333333,2.8,79
sub-2085_ses-T1,163,360,0.4528,197,394,6.566666667,2.8,80
sub-2086_ses-T1,40,360,0.1111,320,640,10.66666667,2.8,81
sub-2087_ses-T1,328,360,0.9111,32,64,1.066666667,2.8,82
sub-2088_ses-T1,224,360,0.6222,136,272,4.533333333,2.8,83
sub-2089_ses-T1,158,180,0.8778,22,44,0.733333333,2.8,84
sub-2091_ses-T1,87,360,0.2417,273,546,9.1,2.8,85
sub-2092_ses-T1,221,360,0.6139,139,278,4.633333333,2.8,86
sub-2093_ses-T1,234,360,0.65,126,252,4.2,2.8,87
sub-2094_ses-T1,167,180,0.9278,13,26,0.433333333,2.8,88
sub-2095_ses-T1,248,360,0.6889,112,224,3.733333333,2.8,89
sub-2096_ses-T1,205,360,0.5694,155,310,5.166666667,2.8,90
sub-2097_ses-T1,388,540,0.7185,152,304,5.066666667,2.8,91
sub-2098_ses-T1,65,360,0.1806,295,590,9.833333333,2.8,92
sub-2099_ses-T1,74,180,0.4111,106,212,3.533333333,2.8,93
sub-2099_ses-T2,103,360,0.2861,257,514,8.566666667,2.8,94
sub-2100_ses-T1,104,180,0.5778,76,152,2.533333333,2.8,95
sub-2100_ses-T2,92,360,0.2556,268,536,8.933333333,2.8,96
sub-2101_ses-T1,198,360,0.55,162,324,5.4,2.8,97
sub-2101_ses-T2,129,360,0.3583,231,462,7.7,2.8,98
sub-2102_ses-T1,233,360,0.6472,127,254,4.233333333,2.8,99
sub-2103_ses-T1,163,360,0.4528,197,394,6.566666667,2.8,100
sub-2103_ses-T2,268,360,0.7444,92,184,3.066666667,2.8,101
sub-2104_ses-T1,300,387,0.7752,87,174,2.9,2.8,102
sub-2105_ses-T1,254,360,0.7056,106,212,3.533333333,2.8,103
sub-2105_ses-T2,256,360,0.7111,104,208,3.466666667,2.8,104
sub-2106_ses-T1,279,360,0.775,81,162,2.7,2.8,105
sub-2107_ses-T1,112,360,0.3111,248,496,8.266666667,2.8,106
sub-2107_ses-T2,151,360,0.4194,209,418,6.966666667,2.8,107
sub-2108_ses-T1,329,360,0.9139,31,62,1.033333333,2.8,108
sub-2108_ses-T3,105,141,0.7447,36,72,1.2,2.8,109
sub-2109_ses-T1,88,180,0.4889,92,184,3.066666667,2.8,110
sub-2110_ses-T1,218,274,0.7956,56,112,1.866666667,2.8,111
sub-2115_ses-T1,236,360,0.6556,124,248,4.133333333,2.8,112
sub-2115_ses-T2,151,360,0.4194,209,418,6.966666667,2.8,113
sub-2117_ses-T1,221,360,0.6139,139,278,4.633333333,2.8,114
sub-2117_ses-T2,76,360,0.2111,284,568,9.466666667,2.8,115
sub-2118_ses-T1,151,360,0.4194,209,418,6.966666667,2.8,116
sub-2120_ses-T1,209,360,0.5806,151,302,5.033333333,2.8,117
sub-2122_ses-T1,207,360,0.575,153,306,5.1,2.8,118
sub-2123_ses-T1,314,360,0.8722,46,92,1.533333333,2.8,119
sub-2124_ses-T1,338,404,0.8366,66,132,2.2,2.8,120
sub-2126_ses-T1,235,360,0.6528,125,250,4.166666667,2.8,121
sub-2128_ses-T1,242,360,0.6722,118,236,3.933333333,2.8,122
sub-2133_ses-T1,174,360,0.4833,186,372,6.2,2.8,123
sub-2135_ses-T1,7,19,0.3684,12,24,0.4,2.8,124
sub-2136_ses-T1,349,720,0.4847,371,742,12.36666667,2.8,125
sub-2137_ses-T1,286,720,0.3972,434,868,14.46666667,2.8,126
sub-2137_ses-T2,109,360,0.3028,251,502,8.366666667,2.8,127
sub-2138_ses-T1,285,360,0.7917,75,150,2.5,2.8,128
sub-2139_ses-T1,86,360,0.2389,274,548,9.133333333,2.8,129
sub-2140_ses-T1,377,379,0.9947,2,4,0.066666667,2.8,130
sub-2141_ses-T1,149,360,0.4139,211,422,7.033333333,2.8,131
sub-2142_ses-T2,300,360,0.8333,60,120,2,2.8,132
sub-2143_ses-T1,180,360,0.5,180,360,6,2.8,133
sub-2144_ses-T1,205,372,0.5511,167,334,5.566666667,2.8,134
sub-2145_ses-T1,200,360,0.5556,160,320,5.333333333,2.8,135
sub-2145_ses-T2,54,360,0.15,306,612,10.2,2.8,136
sub-2146_ses-T1,296,360,0.8222,64,128,2.133333333,2.8,137
sub-2146_ses-T2,308,720,0.4278,412,824,13.73333333,2.8,138
sub-2147_ses-T1,184,360,0.5111,176,352,5.866666667,2.8,139
sub-2147_ses-T2,202,360,0.5611,158,316,5.266666667,2.8,140
sub-2148_ses-T1,333,399,0.8346,66,132,2.2,2.8,141
sub-2149_ses-T1,213,360,0.5917,147,294,4.9,2.8,142
sub-2150_ses-T1,314,360,0.8722,46,92,1.533333333,2.8,143
sub-2150_ses-T2,188,360,0.5222,172,344,5.733333333,2.8,144
sub-2151_ses-T1,326,720,0.4528,394,788,13.13333333,2.8,145
sub-2151_ses-T2,417,773,0.5395,356,712,11.86666667,2.8,146
sub-2152_ses-T1,319,360,0.8861,41,82,1.366666667,2.8,147
sub-2152_ses-T2,152,360,0.4222,208,416,6.933333333,2.8,148
sub-2153_ses-T1,315,383,0.8225,68,136,2.266666667,2.8,149
sub-2154_ses-T2,295,360,0.8194,65,130,2.166666667,2.8,150
sub-2155_ses-T1,183,360,0.5083,177,354,5.9,2.8,151
sub-2156_ses-T1,128,360,0.3556,232,464,7.733333333,2.8,152
sub-2157_ses-T1,272,360,0.7556,88,176,2.933333333,2.8,153
sub-2158_ses-T1,219,360,0.6083,141,282,4.7,2.8,154
sub-2159_ses-T1,147,360,0.4083,213,426,7.1,2.8,155
sub-2160_ses-T1,106,360,0.2944,254,508,8.466666667,2.8,156
sub-2161_ses-T1,216,360,0.6,144,288,4.8,2.8,157
sub-2162_ses-T1,258,360,0.7167,102,204,3.4,2.8,158
sub-2163_ses-T1,302,399,0.7569,97,194,3.233333333,2.8,159
sub-2164_ses-T1,154,720,0.2139,566,1132,18.86666667,2.8,160
sub-2164_ses-T2,371,720,0.5153,349,698,11.63333333,2.8,161
sub-2165_ses-T1,217,481,0.4511,264,528,8.8,2.8,162
sub-2166_ses-T1,230,360,0.6389,130,260,4.333333333,2.8,163
sub-2166_ses-T2,174,360,0.4833,186,372,6.2,2.8,164
sub-2167_ses-T1,289,370,0.7811,81,162,2.7,2.8,165
sub-2168_ses-T1,275,360,0.7639,85,170,2.833333333,2.8,166
sub-2168_ses-T2,214,360,0.5944,146,292,4.866666667,2.8,167
sub-2169_ses-T1,266,360,0.7389,94,188,3.133333333,2.8,168
sub-2169_ses-T2,158,360,0.4389,202,404,6.733333333,2.8,169
sub-2170_ses-T1,128,264,0.4848,136,272,4.533333333,2.8,170
sub-2171_ses-T1,283,374,0.7567,91,182,3.033333333,2.8,171
sub-2171_ses-T2,208,483,0.4306,275,550,9.166666667,2.8,172
sub-2171_ses-T3,151,577,0.2617,426,852,14.2,2.8,173
sub-2172_ses-T1,210,513,0.4094,303,606,10.1,2.8,174
sub-2172_ses-T2,289,386,0.7487,97,194,3.233333333,2.8,175
sub-2173_ses-T1,108,360,0.3,252,504,8.4,2.8,176
sub-2174_ses-T1,204,416,0.4904,212,424,7.066666667,2.8,177
sub-2175_ses-T1,512,679,0.7541,167,334,5.566666667,2.8,178
sub-2176_ses-T1,122,360,0.3389,238,476,7.933333333,2.8,179
sub-2176_ses-T2,0,360,0,360,720,12,2.8,180
sub-2177_ses-T1,633,695,0.9108,62,124,2.066666667,2.8,181
sub-2177_ses-T2,408,736,0.5543,328,656,10.93333333,2.8,182
sub-2178_ses-T2,122,360,0.3389,238,476,7.933333333,2.8,183
sub-2179_ses-T2,352,720,0.4889,368,736,12.26666667,2.8,184
sub-2180_ses-T1,143,360,0.3972,217,434,7.233333333,2.8,185
sub-2180_ses-T2,44,360,0.1222,316,632,10.53333333,2.8,186
sub-2181_ses-T1,281,360,0.7806,79,158,2.633333333,2.8,187
sub-2182_ses-T1,31,51,0.6078,20,40,0.666666667,2.8,188
sub-2184_ses-T1,281,391,0.7187,110,220,3.666666667,2.8,189
sub-2185_ses-T1,250,360,0.6944,110,220,3.666666667,2.8,190
sub-2186_ses-T1,74,371,0.1995,297,594,9.9,2.8,191
sub-2187_ses-T1,39,48,0.8125,9,18,0.3,2.8,192
sub-2188_ses-T1,370,445,0.8315,75,150,2.5,2.8,193
sub-2189_ses-T1,175,204,0.8578,29,58,0.966666667,2.8,194
sub-2190_ses-T1,180,360,0.5,180,360,6,2.8,195
sub-2191_ses-T1,274,360,0.7611,86,172,2.866666667,2.8,196
sub-2191_ses-T2,1,360,0.0028,359,718,11.96666667,2.8,197
sub-2192_ses-T1,263,360,0.7306,97,194,3.233333333,2.8,198
sub-2193_ses-T2,459,625,0.7344,166,332,5.533333333,2.8,199
sub-2194_ses-T1,274,415,0.6602,141,282,4.7,2.8,200
sub-2195_ses-T1,64,360,0.1778,296,592,9.866666667,2.8,201
sub-2196_ses-T1,116,416,0.2788,300,600,10,2.8,202
sub-2197_ses-T1,320,439,0.7289,119,238,3.966666667,2.8,203
sub-2197_ses-T2,118,384,0.3073,266,532,8.866666667,2.8,204
sub-2198_ses-T1,270,407,0.6634,137,274,4.566666667,2.8,205
sub-2199_ses-T1,270,404,0.6683,134,268,4.466666667,2.8,206
sub-2200_ses-T1,120,360,0.3333,240,480,8,2.8,207
sub-2201_ses-T1,253,360,0.7028,107,214,3.566666667,2.8,208
sub-2202_ses-T1,179,606,0.2954,427,854,14.23333333,2.8,209
sub-2203_ses-T1,158,360,0.4389,202,404,6.733333333,2.8,210
sub-2204_ses-T1,241,360,0.6694,119,238,3.966666667,2.8,211
sub-2204_ses-T2,245,360,0.6806,115,230,3.833333333,2.8,212
sub-2205_ses-T1,190,360,0.5278,170,340,5.666666667,2.8,213
sub-2206_ses-T1,289,360,0.8028,71,142,2.366666667,2.8,214
sub-2206_ses-T2,268,720,0.3722,452,904,15.06666667,2.8,215
sub-2207_ses-T1,70,360,0.1944,290,580,9.666666667,2.8,216
sub-2207_ses-T2,96,360,0.2667,264,528,8.8,2.8,217
sub-2208_ses-T1,271,360,0.7528,89,178,2.966666667,2.8,218
sub-2208_ses-T2,150,360,0.4167,210,420,7,2.8,219
sub-2209_ses-T1,233,341,0.6833,108,216,3.6,2.8,220
sub-2210_ses-T1,26,38,0.6842,12,24,0.4,2.8,221
sub-2211_ses-T1,247,360,0.6861,113,226,3.766666667,2.8,222
sub-2212_ses-T1,276,360,0.7667,84,168,2.8,2.8,223
sub-2213_ses-T1,124,286,0.4336,162,324,5.4,2.8,224
sub-2214_ses-T1,325,373,0.8713,48,96,1.6,2.8,225
sub-2215_ses-T1,277,360,0.7694,83,166,2.766666667,2.8,226
sub-2216_ses-T1,26,86,0.3023,60,120,2,2.8,227
sub-2216_ses-T2,73,181,0.4033,108,216,3.6,2.8,228
sub-2217_ses-T1,85,360,0.2361,275,550,9.166666667,2.8,229
sub-2217_ses-T2,18,360,0.05,342,684,11.4,2.8,230
sub-2218_ses-T1,167,360,0.4639,193,386,6.433333333,2.8,231
sub-2218_ses-T2,164,720,0.2278,556,1112,18.53333333,2.8,232
sub-2219_ses-T1,322,360,0.8944,38,76,1.266666667,2.8,233
sub-2220_ses-T1,290,360,0.8056,70,140,2.333333333,2.8,234
sub-2220_ses-T2,78,720,0.1083,642,1284,21.4,2.8,235
sub-2221_ses-T1,92,360,0.2556,268,536,8.933333333,2.8,236
sub-2221_ses-T2,308,720,0.4278,412,824,13.73333333,2.8,237
sub-2222_ses-T1,132,360,0.3667,228,456,7.6,2.8,238
sub-2223_ses-T1,225,360,0.625,135,270,4.5,2.8,239
sub-2223_ses-T2,270,720,0.375,450,900,15,2.8,240
sub-2224_ses-T1,166,379,0.438,213,426,7.1,2.8,241
sub-2225_ses-T1,254,360,0.7056,106,212,3.533333333,2.8,242
sub-2225_ses-T2,282,759,0.3715,477,954,15.9,2.8,243
sub-2226_ses-T1,98,365,0.2685,267,534,8.9,2.8,244
sub-2226_ses-T2,52,360,0.1444,308,616,10.26666667,2.8,245
sub-2227_ses-T1,225,360,0.625,135,270,4.5,2.8,246
sub-2228_ses-T1,262,360,0.7278,98,196,3.266666667,2.8,247
sub-2228_ses-T2,301,729,0.4129,428,856,14.26666667,2.8,248
sub-2229_ses-T1,310,360,0.8611,50,100,1.666666667,2.8,249
sub-2229_ses-T2,85,390,0.2179,305,610,10.16666667,2.8,250
sub-2230_ses-T1,333,398,0.8367,65,130,2.166666667,2.8,251
sub-7001_ses-f2,198,720,0.275,522,1044,17.4,2.8,252
sub-7001_ses-f3,56,720,0.0778,664,1328,22.13333333,2.8,253
sub-7002_ses-f1,224,720,0.3111,496,992,16.53333333,2.8,254
sub-7002_ses-f2,284,720,0.3944,436,872,14.53333333,2.8,255
sub-7003_ses-f1,110,360,0.3056,250,500,8.333333333,2.8,256
sub-7003_ses-f2,5,180,0.0278,175,350,5.833333333,2.8,257
sub-7004_ses-f3,296,724,0.4088,428,856,14.26666667,2.8,258
sub-7006_ses-f1,38,52,0.7308,14,28,0.466666667,2.8,259
sub-7008_ses-f1,426,720,0.5917,294,588,9.8,2.8,260
sub-7008_ses-f2,96,720,0.1333,624,1248,20.8,2.8,261
sub-7009_ses-f1,330,720,0.4583,390,780,13,2.8,262
sub-7009_ses-f2,179,720,0.2486,541,1082,18.03333333,2.8,263
sub-7011_ses-f1,864,917,0.9422,53,106,1.766666667,2.8,264
sub-7011_ses-f2,111,360,0.3083,249,498,8.3,2.8,265
sub-7012_ses-f1,646,761,0.8489,115,230,3.833333333,2.8,266
sub-7012_ses-f2,378,720,0.525,342,684,11.4,2.8,267
sub-7014_ses-f1,72,360,0.2,288,576,9.6,2.8,268
sub-7014_ses-f2,322,720,0.4472,398,796,13.26666667,2.8,269
sub-7015_ses-f1,628,832,0.7548,204,408,6.8,2.8,270
sub-7015_ses-f2,284,729,0.3896,445,890,14.83333333,2.8,271
sub-7016_ses-f1,394,750,0.5253,356,712,11.86666667,2.8,272
sub-7016_ses-f2,84,720,0.1167,636,1272,21.2,2.8,273
sub-7017_ses-f1,683,740,0.923,57,114,1.9,2.8,274
sub-7017_ses-f2,509,725,0.7021,216,432,7.2,2.8,275
sub-7020_ses-f1,191,740,0.2581,549,1098,18.3,2.8,276
sub-7020_ses-f2,168,720,0.2333,552,1104,18.4,2.8,277
sub-7021_ses-f1,657,753,0.8725,96,192,3.2,2.8,278
sub-7022_ses-f1,599,720,0.8319,121,242,4.033333333,2.8,279
sub-7022_ses-f2,449,727,0.6176,278,556,9.266666667,2.8,280
sub-7023_ses-f1,431,744,0.5793,313,626,10.43333333,2.8,281
sub-7023_ses-f2,486,829,0.5862,343,686,11.43333333,2.8,282
sub-7024_ses-f1,563,728,0.7734,165,330,5.5,2.8,283
sub-7025_ses-f1,272,729,0.3731,457,914,15.23333333,2.8,284
sub-7025_ses-f2,163,760,0.2145,597,1194,19.9,2.8,285
sub-7026_ses-f1,548,920,0.5957,372,744,12.4,2.8,286
sub-7026_ses-f2,572,914,0.6258,342,684,11.4,2.8,287
sub-7026_ses-f3,100,731,0.1368,631,1262,21.03333333,2.8,288
sub-7027_ses-f1,803,885,0.9073,82,164,2.733333333,2.8,289
sub-7027_ses-f2,108,410,0.2634,302,604,10.06666667,2.8,290
sub-7027_ses-f3,96,725,0.1324,629,1258,20.96666667,2.8,291
sub-7028_ses-f1,712,752,0.9468,40,80,1.333333333,2.8,292
sub-7028_ses-f2,553,720,0.7681,167,334,5.566666667,2.8,293
sub-7029_ses-f1,375,731,0.513,356,712,11.86666667,2.8,294
sub-7029_ses-f2,273,725,0.3766,452,904,15.06666667,2.8,295
sub-7030_ses-f1,455,720,0.6319,265,530,8.833333333,2.8,296
sub-7030_ses-f2,264,794,0.3325,530,1060,17.66666667,2.8,297
sub-7031_ses-f1,12,192,0.0625,180,360,6,2.8,298
sub-7031_ses-f2,10,374,0.0267,364,728,12.13333333,2.8,299
sub-7031_ses-f3,321,737,0.4355,416,832,13.86666667,2.8,300
sub-7032_ses-f1,695,720,0.9653,25,50,0.833333333,2.8,301
sub-7032_ses-f2,45,73,0.6164,28,56,0.933333333,2.8,302
sub-7032_ses-f3,472,740,0.6378,268,536,8.933333333,2.8,303
sub-7033_ses-f2,278,752,0.3697,474,948,15.8,2.8,304
sub-7034_ses-f1,603,760,0.7934,157,314,5.233333333,2.8,305
sub-7034_ses-f2,494,912,0.5417,418,836,13.93333333,2.8,306
sub-7034_ses-f3,102,728,0.1401,626,1252,20.86666667,2.8,307
sub-7035_ses-f1,11,50,0.22,39,78,1.3,2.8,308
sub-7035_ses-f2,110,727,0.1513,617,1234,20.56666667,2.8,309
sub-7036_ses-f1,228,745,0.306,517,1034,17.23333333,2.8,310
sub-7037_ses-f1,738,772,0.956,34,68,1.133333333,2.8,311
sub-7037_ses-f2,697,852,0.8181,155,310,5.166666667,2.8,312
sub-7037_ses-f3,190,720,0.2639,530,1060,17.66666667,2.8,313
sub-7038_ses-f1,483,789,0.6122,306,612,10.2,2.8,314
sub-7038_ses-f2,245,785,0.3121,540,1080,18,2.8,315
sub-7039_ses-f1,426,785,0.5427,359,718,11.96666667,2.8,316
sub-7039_ses-f2,242,727,0.3329,485,970,16.16666667,2.8,317
sub-7040_ses-f1,344,728,0.4725,384,768,12.8,2.8,318
sub-7040_ses-f2,181,720,0.2514,539,1078,17.96666667,2.8,319
sub-7040_ses-f3,193,720,0.2681,527,1054,17.56666667,2.8,320
sub-7041_ses-f1,557,754,0.7387,197,394,6.566666667,2.8,321
sub-7041_ses-f2,198,735,0.2694,537,1074,17.9,2.8,322
sub-7042_ses-f3,264,658,0.4012,394,788,13.13333333,2.8,323
sub-7043_ses-f2,375,1080,0.3472,705,1410,23.5,2.8,324
sub-7044_ses-f2,374,739,0.5061,365,730,12.16666667,2.8,325
sub-7045_ses-f1,568,823,0.6902,255,510,8.5,2.8,326
sub-7046_ses-f1,468,812,0.5764,344,688,11.46666667,2.8,327
sub-7046_ses-f2,30,61,0.4918,31,62,1.033333333,2.8,328
sub-7046_ses-f3,115,741,0.1552,626,1252,20.86666667,2.8,329
sub-7047_ses-f1,464,720,0.6444,256,512,8.533333333,2.8,330
sub-7047_ses-f2,31,64,0.4844,33,66,1.1,2.8,331
sub-7048_ses-f1,4,6,0.6667,2,4,0.066666667,2.8,332
sub-7048_ses-f2,160,360,0.4444,200,400,6.666666667,2.8,333
sub-7049_ses-f1,70,360,0.1944,290,580,9.666666667,2.8,334
sub-7052_ses-f1,104,518,0.2008,414,828,13.8,2.8,335
sub-7053_ses-f1,355,720,0.4931,365,730,12.16666667,2.8,336
sub-7054_ses-f1,510,766,0.6658,256,512,8.533333333,2.8,337
sub-2006_ses-T1,147,420,0.35,273,546,9.1,3,1
sub-2011_ses-T1,121,360,0.3361,239,478,7.966666667,3,2
sub-2012_ses-T1,179,180,0.9944,1,2,0.033333333,3,3
sub-2013_ses-T1,158,360,0.4389,202,404,6.733333333,3,4
sub-2014_ses-T1,179,360,0.4972,181,362,6.033333333,3,5
sub-2015_ses-T1,13,180,0.0722,167,334,5.566666667,3,6
sub-2016_ses-T1,156,360,0.4333,204,408,6.8,3,7
sub-2017_ses-T1,141,180,0.7833,39,78,1.3,3,8
sub-2018_ses-T1,51,180,0.2833,129,258,4.3,3,9
sub-2019_ses-T1,237,360,0.6583,123,246,4.1,3,10
sub-2020_ses-T1,17,26,0.6538,9,18,0.3,3,11
sub-2020_ses-T2,116,360,0.3222,244,488,8.133333333,3,12
sub-2021_ses-T1,120,360,0.3333,240,480,8,3,13
sub-2022_ses-T1,173,360,0.4806,187,374,6.233333333,3,14
sub-2023_ses-T1,90,360,0.25,270,540,9,3,15
sub-2024_ses-T2,4,12,0.3333,8,16,0.266666667,3,16
sub-2026_ses-T1,94,223,0.4215,129,258,4.3,3,17
sub-2027_ses-T1,272,360,0.7556,88,176,2.933333333,3,18
sub-2028_ses-T1,118,360,0.3278,242,484,8.066666667,3,19
sub-2029_ses-T1,166,360,0.4611,194,388,6.466666667,3,20
sub-2030_ses-T1,73,360,0.2028,287,574,9.566666667,3,21
sub-2031_ses-T1,337,360,0.9361,23,46,0.766666667,3,22
sub-2032_ses-T1,67,360,0.1861,293,586,9.766666667,3,23
sub-2033_ses-T1,282,360,0.7833,78,156,2.6,3,24
sub-2033_ses-T2,98,360,0.2722,262,524,8.733333333,3,25
sub-2034_ses-T1,5,180,0.0278,175,350,5.833333333,3,26
sub-2035_ses-T1,290,360,0.8056,70,140,2.333333333,3,27
sub-2036_ses-T1,218,360,0.6056,142,284,4.733333333,3,28
sub-2037_ses-T1,191,360,0.5306,169,338,5.633333333,3,29
sub-2038_ses-T1,307,360,0.8528,53,106,1.766666667,3,30
sub-2039_ses-T1,175,180,0.9722,5,10,0.166666667,3,31
sub-2040_ses-T1,250,360,0.6944,110,220,3.666666667,3,32
sub-2041_ses-T1,237,360,0.6583,123,246,4.1,3,33
sub-2042_ses-T1,31,180,0.1722,149,298,4.966666667,3,34
sub-2043_ses-T1,70,360,0.1944,290,580,9.666666667,3,35
sub-2044_ses-T1,100,360,0.2778,260,520,8.666666667,3,36
sub-2045_ses-T1,12,180,0.0667,168,336,5.6,3,37
sub-2046_ses-T1,104,180,0.5778,76,152,2.533333333,3,38
sub-2047_ses-T1,42,180,0.2333,138,276,4.6,3,39
sub-2048_ses-T1,129,180,0.7167,51,102,1.7,3,40
sub-2049_ses-T1,218,360,0.6056,142,284,4.733333333,3,41
sub-2051_ses-T1,307,360,0.8528,53,106,1.766666667,3,42
sub-2051_ses-T2,317,360,0.8806,43,86,1.433333333,3,43
sub-2052_ses-T1,160,360,0.4444,200,400,6.666666667,3,44
sub-2052_ses-T2,33,180,0.1833,147,294,4.9,3,45
sub-2053_ses-T1,109,360,0.3028,251,502,8.366666667,3,46
sub-2055_ses-T1,38,180,0.2111,142,284,4.733333333,3,47
sub-2056_ses-T1,347,360,0.9639,13,26,0.433333333,3,48
sub-2057_ses-T1,201,360,0.5583,159,318,5.3,3,49
sub-2058_ses-T1,185,360,0.5139,175,350,5.833333333,3,50
sub-2059_ses-T1,184,360,0.5111,176,352,5.866666667,3,51
sub-2061_ses-T1,38,180,0.2111,142,284,4.733333333,3,52
sub-2062_ses-T1,291,360,0.8083,69,138,2.3,3,53
sub-2063_ses-T1,119,360,0.3306,241,482,8.033333333,3,54
sub-2064_ses-T1,94,180,0.5222,86,172,2.866666667,3,55
sub-2065_ses-T1,5,180,0.0278,175,350,5.833333333,3,56
sub-2066_ses-T1,108,180,0.6,72,144,2.4,3,57
sub-2066_ses-T2,182,360,0.5056,178,356,5.933333333,3,58
sub-2067_ses-T1,169,360,0.4694,191,382,6.366666667,3,59
sub-2068_ses-T1,228,360,0.6333,132,264,4.4,3,60
sub-2069_ses-T1,78,360,0.2167,282,564,9.4,3,61
sub-2070_ses-T1,198,360,0.55,162,324,5.4,3,62
sub-2071_ses-T1,213,360,0.5917,147,294,4.9,3,63
sub-2072_ses-T1,251,360,0.6972,109,218,3.633333333,3,64
sub-2073_ses-T1,233,256,0.9102,23,46,0.766666667,3,65
sub-2073_ses-T2,61,180,0.3389,119,238,3.966666667,3,66
sub-2074_ses-T1,15,180,0.0833,165,330,5.5,3,67
sub-2075_ses-T1,116,180,0.6444,64,128,2.133333333,3,68
sub-2076_ses-T1,118,360,0.3278,242,484,8.066666667,3,69
sub-2076_ses-T2,49,360,0.1361,311,622,10.36666667,3,70
sub-2077_ses-T1,280,360,0.7778,80,160,2.666666667,3,71
sub-2078_ses-T1,230,360,0.6389,130,260,4.333333333,3,72
sub-2079_ses-T1,195,360,0.5417,165,330,5.5,3,73
sub-2079_ses-T2,74,360,0.2056,286,572,9.533333333,3,74
sub-2080_ses-T1,93,360,0.2583,267,534,8.9,3,75
sub-2081_ses-T1,223,360,0.6194,137,274,4.566666667,3,76
sub-2082_ses-T1,124,360,0.3444,236,472,7.866666667,3,77
sub-2083_ses-T1,90,360,0.25,270,540,9,3,78
sub-2084_ses-T1,328,360,0.9111,32,64,1.066666667,3,79
sub-2085_ses-T1,154,360,0.4278,206,412,6.866666667,3,80
sub-2086_ses-T1,32,360,0.0889,328,656,10.93333333,3,81
sub-2087_ses-T1,326,360,0.9056,34,68,1.133333333,3,82
sub-2088_ses-T1,205,360,0.5694,155,310,5.166666667,3,83
sub-2089_ses-T1,154,180,0.8556,26,52,0.866666667,3,84
sub-2091_ses-T1,80,360,0.2222,280,560,9.333333333,3,85
sub-2092_ses-T1,208,360,0.5778,152,304,5.066666667,3,86
sub-2093_ses-T1,219,360,0.6083,141,282,4.7,3,87
sub-2094_ses-T1,165,180,0.9167,15,30,0.5,3,88
sub-2095_ses-T1,220,360,0.6111,140,280,4.666666667,3,89
sub-2096_ses-T1,185,360,0.5139,175,350,5.833333333,3,90
sub-2097_ses-T1,372,540,0.6889,168,336,5.6,3,91
sub-2098_ses-T1,63,360,0.175,297,594,9.9,3,92
sub-2099_ses-T1,60,180,0.3333,120,240,4,3,93
sub-2099_ses-T2,89,360,0.2472,271,542,9.033333333,3,94
sub-2100_ses-T1,101,180,0.5611,79,158,2.633333333,3,95
sub-2100_ses-T2,86,360,0.2389,274,548,9.133333333,3,96
sub-2101_ses-T1,184,360,0.5111,176,352,5.866666667,3,97
sub-2101_ses-T2,124,360,0.3444,236,472,7.866666667,3,98
sub-2102_ses-T1,213,360,0.5917,147,294,4.9,3,99
sub-2103_ses-T1,155,360,0.4306,205,410,6.833333333,3,100
sub-2103_ses-T2,256,360,0.7111,104,208,3.466666667,3,101
sub-2104_ses-T1,287,387,0.7416,100,200,3.333333333,3,102
sub-2105_ses-T1,245,360,0.6806,115,230,3.833333333,3,103
sub-2105_ses-T2,246,360,0.6833,114,228,3.8,3,104
sub-2106_ses-T1,272,360,0.7556,88,176,2.933333333,3,105
sub-2107_ses-T1,102,360,0.2833,258,516,8.6,3,106
sub-2107_ses-T2,147,360,0.4083,213,426,7.1,3,107
sub-2108_ses-T1,318,360,0.8833,42,84,1.4,3,108
sub-2108_ses-T3,100,141,0.7092,41,82,1.366666667,3,109
sub-2109_ses-T1,82,180,0.4556,98,196,3.266666667,3,110
sub-2110_ses-T1,211,274,0.7701,63,126,2.1,3,111
sub-2115_ses-T1,227,360,0.6306,133,266,4.433333333,3,112
sub-2115_ses-T2,142,360,0.3944,218,436,7.266666667,3,113
sub-2117_ses-T1,199,360,0.5528,161,322,5.366666667,3,114
sub-2117_ses-T2,69,360,0.1917,291,582,9.7,3,115
sub-2118_ses-T1,139,360,0.3861,221,442,7.366666667,3,116
sub-2120_ses-T1,196,360,0.5444,164,328,5.466666667,3,117
sub-2122_ses-T1,200,360,0.5556,160,320,5.333333333,3,118
sub-2123_ses-T1,307,360,0.8528,53,106,1.766666667,3,119
sub-2124_ses-T1,336,404,0.8317,68,136,2.266666667,3,120
sub-2126_ses-T1,217,360,0.6028,143,286,4.766666667,3,121
sub-2128_ses-T1,230,360,0.6389,130,260,4.333333333,3,122
sub-2133_ses-T1,164,360,0.4556,196,392,6.533333333,3,123
sub-2135_ses-T1,7,19,0.3684,12,24,0.4,3,124
sub-2136_ses-T1,337,720,0.4681,383,766,12.76666667,3,125
sub-2137_ses-T1,251,720,0.3486,469,938,15.63333333,3,126
sub-2137_ses-T2,107,360,0.2972,253,506,8.433333333,3,127
sub-2138_ses-T1,269,360,0.7472,91,182,3.033333333,3,128
sub-2139_ses-T1,84,360,0.2333,276,552,9.2,3,129
sub-2140_ses-T1,377,379,0.9947,2,4,0.066666667,3,130
sub-2141_ses-T1,141,360,0.3917,219,438,7.3,3,131
sub-2142_ses-T2,295,360,0.8194,65,130,2.166666667,3,132
sub-2143_ses-T1,173,360,0.4806,187,374,6.233333333,3,133
sub-2144_ses-T1,202,372,0.543,170,340,5.666666667,3,134
sub-2145_ses-T1,190,360,0.5278,170,340,5.666666667,3,135
sub-2145_ses-T2,51,360,0.1417,309,618,10.3,3,136
sub-2146_ses-T1,282,360,0.7833,78,156,2.6,3,137
sub-2146_ses-T2,288,720,0.4,432,864,14.4,3,138
sub-2147_ses-T1,163,360,0.4528,197,394,6.566666667,3,139
sub-2147_ses-T2,178,360,0.4944,182,364,6.066666667,3,140
sub-2148_ses-T1,329,399,0.8246,70,140,2.333333333,3,141
sub-2149_ses-T1,198,360,0.55,162,324,5.4,3,142
sub-2150_ses-T1,304,360,0.8444,56,112,1.866666667,3,143
sub-2150_ses-T2,181,360,0.5028,179,358,5.966666667,3,144
sub-2151_ses-T1,298,720,0.4139,422,844,14.06666667,3,145
sub-2151_ses-T2,407,773,0.5265,366,732,12.2,3,146
sub-2152_ses-T1,312,360,0.8667,48,96,1.6,3,147
sub-2152_ses-T2,147,360,0.4083,213,426,7.1,3,148
sub-2153_ses-T1,306,383,0.799,77,154,2.566666667,3,149
sub-2154_ses-T2,280,360,0.7778,80,160,2.666666667,3,150
sub-2155_ses-T1,167,360,0.4639,193,386,6.433333333,3,151
sub-2156_ses-T1,119,360,0.3306,241,482,8.033333333,3,152
sub-2157_ses-T1,262,360,0.7278,98,196,3.266666667,3,153
sub-2158_ses-T1,208,360,0.5778,152,304,5.066666667,3,154
sub-2159_ses-T1,138,360,0.3833,222,444,7.4,3,155
sub-2160_ses-T1,94,360,0.2611,266,532,8.866666667,3,156
sub-2161_ses-T1,211,360,0.5861,149,298,4.966666667,3,157
sub-2162_ses-T1,248,360,0.6889,112,224,3.733333333,3,158
sub-2163_ses-T1,294,399,0.7368,105,210,3.5,3,159
sub-2164_ses-T1,152,720,0.2111,568,1136,18.93333333,3,160
sub-2164_ses-T2,348,720,0.4833,372,744,12.4,3,161
sub-2165_ses-T1,199,481,0.4137,282,564,9.4,3,162
sub-2166_ses-T1,220,360,0.6111,140,280,4.666666667,3,163
sub-2166_ses-T2,171,360,0.475,189,378,6.3,3,164
sub-2167_ses-T1,281,370,0.7595,89,178,2.966666667,3,165
sub-2168_ses-T1,262,360,0.7278,98,196,3.266666667,3,166
sub-2168_ses-T2,195,360,0.5417,165,330,5.5,3,167
sub-2169_ses-T1,251,360,0.6972,109,218,3.633333333,3,168
sub-2169_ses-T2,149,360,0.4139,211,422,7.033333333,3,169
sub-2170_ses-T1,117,264,0.4432,147,294,4.9,3,170
sub-2171_ses-T1,279,374,0.746,95,190,3.166666667,3,171
sub-2171_ses-T2,197,483,0.4079,286,572,9.533333333,3,172
sub-2171_ses-T3,143,577,0.2478,434,868,14.46666667,3,173
sub-2172_ses-T1,190,513,0.3704,323,646,10.76666667,3,174
sub-2172_ses-T2,282,386,0.7306,104,208,3.466666667,3,175
sub-2173_ses-T1,103,360,0.2861,257,514,8.566666667,3,176
sub-2174_ses-T1,193,416,0.4639,223,446,7.433333333,3,177
sub-2175_ses-T1,499,679,0.7349,180,360,6,3,178
sub-2176_ses-T1,114,360,0.3167,246,492,8.2,3,179
sub-2176_ses-T2,0,360,0,360,720,12,3,180
sub-2177_ses-T1,626,695,0.9007,69,138,2.3,3,181
sub-2177_ses-T2,377,736,0.5122,359,718,11.96666667,3,182
sub-2178_ses-T2,112,360,0.3111,248,496,8.266666667,3,183
sub-2179_ses-T2,334,720,0.4639,386,772,12.86666667,3,184
sub-2180_ses-T1,140,360,0.3889,220,440,7.333333333,3,185
sub-2180_ses-T2,37,360,0.1028,323,646,10.76666667,3,186
sub-2181_ses-T1,276,360,0.7667,84,168,2.8,3,187
sub-2182_ses-T1,30,51,0.5882,21,42,0.7,3,188
sub-2184_ses-T1,270,391,0.6905,121,242,4.033333333,3,189
sub-2185_ses-T1,232,360,0.6444,128,256,4.266666667,3,190
sub-2186_ses-T1,58,371,0.1563,313,626,10.43333333,3,191
sub-2187_ses-T1,39,48,0.8125,9,18,0.3,3,192
sub-2188_ses-T1,358,445,0.8045,87,174,2.9,3,193
sub-2189_ses-T1,171,204,0.8382,33,66,1.1,3,194
sub-2190_ses-T1,173,360,0.4806,187,374,6.233333333,3,195
sub-2191_ses-T1,261,360,0.725,99,198,3.3,3,196
sub-2191_ses-T2,1,360,0.0028,359,718,11.96666667,3,197
sub-2192_ses-T1,249,360,0.6917,111,222,3.7,3,198
sub-2193_ses-T2,444,625,0.7104,181,362,6.033333333,3,199
sub-2194_ses-T1,254,415,0.612,161,322,5.366666667,3,200
sub-2195_ses-T1,60,360,0.1667,300,600,10,3,201
sub-2196_ses-T1,110,416,0.2644,306,612,10.2,3,202
sub-2197_ses-T1,308,439,0.7016,131,262,4.366666667,3,203
sub-2197_ses-T2,104,384,0.2708,280,560,9.333333333,3,204
sub-2198_ses-T1,256,407,0.629,151,302,5.033333333,3,205
sub-2199_ses-T1,259,404,0.6411,145,290,4.833333333,3,206
sub-2200_ses-T1,114,360,0.3167,246,492,8.2,3,207
sub-2201_ses-T1,240,360,0.6667,120,240,4,3,208
sub-2202_ses-T1,160,606,0.264,446,892,14.86666667,3,209
sub-2203_ses-T1,139,360,0.3861,221,442,7.366666667,3,210
sub-2204_ses-T1,235,360,0.6528,125,250,4.166666667,3,211
sub-2204_ses-T2,234,360,0.65,126,252,4.2,3,212
sub-2205_ses-T1,173,360,0.4806,187,374,6.233333333,3,213
sub-2206_ses-T1,284,360,0.7889,76,152,2.533333333,3,214
sub-2206_ses-T2,250,720,0.3472,470,940,15.66666667,3,215
sub-2207_ses-T1,65,360,0.1806,295,590,9.833333333,3,216
sub-2207_ses-T2,82,360,0.2278,278,556,9.266666667,3,217
sub-2208_ses-T1,260,360,0.7222,100,200,3.333333333,3,218
sub-2208_ses-T2,142,360,0.3944,218,436,7.266666667,3,219
sub-2209_ses-T1,220,341,0.6452,121,242,4.033333333,3,220
sub-2210_ses-T1,26,38,0.6842,12,24,0.4,3,221
sub-2211_ses-T1,227,360,0.6306,133,266,4.433333333,3,222
sub-2212_ses-T1,266,360,0.7389,94,188,3.133333333,3,223
sub-2213_ses-T1,119,286,0.4161,167,334,5.566666667,3,224
sub-2214_ses-T1,319,373,0.8552,54,108,1.8,3,225
sub-2215_ses-T1,254,360,0.7056,106,212,3.533333333,3,226
sub-2216_ses-T1,23,86,0.2674,63,126,2.1,3,227
sub-2216_ses-T2,67,181,0.3702,114,228,3.8,3,228
sub-2217_ses-T1,77,360,0.2139,283,566,9.433333333,3,229
sub-2217_ses-T2,17,360,0.0472,343,686,11.43333333,3,230
sub-2218_ses-T1,147,360,0.4083,213,426,7.1,3,231
sub-2218_ses-T2,152,720,0.2111,568,1136,18.93333333,3,232
sub-2219_ses-T1,317,360,0.8806,43,86,1.433333333,3,233
sub-2220_ses-T1,280,360,0.7778,80,160,2.666666667,3,234
sub-2220_ses-T2,46,720,0.0639,674,1348,22.46666667,3,235
sub-2221_ses-T1,79,360,0.2194,281,562,9.366666667,3,236
sub-2221_ses-T2,306,720,0.425,414,828,13.8,3,237
sub-2222_ses-T1,126,360,0.35,234,468,7.8,3,238
sub-2223_ses-T1,212,360,0.5889,148,296,4.933333333,3,239
sub-2223_ses-T2,232,720,0.3222,488,976,16.26666667,3,240
sub-2224_ses-T1,160,379,0.4222,219,438,7.3,3,241
sub-2225_ses-T1,241,360,0.6694,119,238,3.966666667,3,242
sub-2225_ses-T2,245,759,0.3228,514,1028,17.13333333,3,243
sub-2226_ses-T1,96,365,0.263,269,538,8.966666667,3,244
sub-2226_ses-T2,46,360,0.1278,314,628,10.46666667,3,245
sub-2227_ses-T1,205,360,0.5694,155,310,5.166666667,3,246
sub-2228_ses-T1,246,360,0.6833,114,228,3.8,3,247
sub-2228_ses-T2,274,729,0.3759,455,910,15.16666667,3,248
sub-2229_ses-T1,304,360,0.8444,56,112,1.866666667,3,249
sub-2229_ses-T2,65,390,0.1667,325,650,10.83333333,3,250
sub-2230_ses-T1,318,398,0.799,80,160,2.666666667,3,251
sub-7001_ses-f2,183,720,0.2542,537,1074,17.9,3,252
sub-7001_ses-f3,53,720,0.0736,667,1334,22.23333333,3,253
sub-7002_ses-f1,193,720,0.2681,527,1054,17.56666667,3,254
sub-7002_ses-f2,273,720,0.3792,447,894,14.9,3,255
sub-7003_ses-f1,92,360,0.2556,268,536,8.933333333,3,256
sub-7003_ses-f2,5,180,0.0278,175,350,5.833333333,3,257
sub-7004_ses-f3,287,724,0.3964,437,874,14.56666667,3,258
sub-7006_ses-f1,36,52,0.6923,16,32,0.533333333,3,259
sub-7008_ses-f1,397,720,0.5514,323,646,10.76666667,3,260
sub-7008_ses-f2,88,720,0.1222,632,1264,21.06666667,3,261
sub-7009_ses-f1,318,720,0.4417,402,804,13.4,3,262
sub-7009_ses-f2,173,720,0.2403,547,1094,18.23333333,3,263
sub-7011_ses-f1,855,917,0.9324,62,124,2.066666667,3,264
sub-7011_ses-f2,100,360,0.2778,260,520,8.666666667,3,265
sub-7012_ses-f1,633,761,0.8318,128,256,4.266666667,3,266
sub-7012_ses-f2,358,720,0.4972,362,724,12.06666667,3,267
sub-7014_ses-f1,65,360,0.1806,295,590,9.833333333,3,268
sub-7014_ses-f2,297,720,0.4125,423,846,14.1,3,269
sub-7015_ses-f1,613,832,0.7368,219,438,7.3,3,270
sub-7015_ses-f2,264,729,0.3621,465,930,15.5,3,271
sub-7016_ses-f1,379,750,0.5053,371,742,12.36666667,3,272
sub-7016_ses-f2,79,720,0.1097,641,1282,21.36666667,3,273
sub-7017_ses-f1,664,740,0.8973,76,152,2.533333333,3,274
sub-7017_ses-f2,487,725,0.6717,238,476,7.933333333,3,275
sub-7020_ses-f1,176,740,0.2378,564,1128,18.8,3,276
sub-7020_ses-f2,160,720,0.2222,560,1120,18.66666667,3,277
sub-7021_ses-f1,644,753,0.8552,109,218,3.633333333,3,278
sub-7022_ses-f1,582,720,0.8083,138,276,4.6,3,279
sub-7022_ses-f2,407,727,0.5598,320,640,10.66666667,3,280
sub-7023_ses-f1,407,744,0.547,337,674,11.23333333,3,281
sub-7023_ses-f2,464,829,0.5597,365,730,12.16666667,3,282
sub-7024_ses-f1,540,728,0.7418,188,376,6.266666667,3,283
sub-7025_ses-f1,247,729,0.3388,482,964,16.06666667,3,284
sub-7025_ses-f2,154,760,0.2026,606,1212,20.2,3,285
sub-7026_ses-f1,529,920,0.575,391,782,13.03333333,3,286
sub-7026_ses-f2,537,914,0.5875,377,754,12.56666667,3,287
sub-7026_ses-f3,92,731,0.1259,639,1278,21.3,3,288
sub-7027_ses-f1,786,885,0.8881,99,198,3.3,3,289
sub-7027_ses-f2,99,410,0.2415,311,622,10.36666667,3,290
sub-7027_ses-f3,84,725,0.1159,641,1282,21.36666667,3,291
sub-7028_ses-f1,707,752,0.9402,45,90,1.5,3,292
sub-7028_ses-f2,525,720,0.7292,195,390,6.5,3,293
sub-7029_ses-f1,348,731,0.4761,383,766,12.76666667,3,294
sub-7029_ses-f2,247,725,0.3407,478,956,15.93333333,3,295
sub-7030_ses-f1,440,720,0.6111,280,560,9.333333333,3,296
sub-7030_ses-f2,243,794,0.306,551,1102,18.36666667,3,297
sub-7031_ses-f1,11,192,0.0573,181,362,6.033333333,3,298
sub-7031_ses-f2,8,374,0.0214,366,732,12.2,3,299
sub-7031_ses-f3,295,737,0.4003,442,884,14.73333333,3,300
sub-7032_ses-f1,691,720,0.9597,29,58,0.966666667,3,301
sub-7032_ses-f2,42,73,0.5753,31,62,1.033333333,3,302
sub-7032_ses-f3,440,740,0.5946,300,600,10,3,303
sub-7033_ses-f2,272,752,0.3617,480,960,16,3,304
sub-7034_ses-f1,591,760,0.7776,169,338,5.633333333,3,305
sub-7034_ses-f2,472,912,0.5175,440,880,14.66666667,3,306
sub-7034_ses-f3,97,728,0.1332,631,1262,21.03333333,3,307
sub-7035_ses-f1,11,50,0.22,39,78,1.3,3,308
sub-7035_ses-f2,104,727,0.1431,623,1246,20.76666667,3,309
sub-7036_ses-f1,216,745,0.2899,529,1058,17.63333333,3,310
sub-7037_ses-f1,730,772,0.9456,42,84,1.4,3,311
sub-7037_ses-f2,667,852,0.7829,185,370,6.166666667,3,312
sub-7037_ses-f3,166,720,0.2306,554,1108,18.46666667,3,313
sub-7038_ses-f1,459,789,0.5817,330,660,11,3,314
sub-7038_ses-f2,237,785,0.3019,548,1096,18.26666667,3,315
sub-7039_ses-f1,402,785,0.5121,383,766,12.76666667,3,316
sub-7039_ses-f2,219,727,0.3012,508,1016,16.93333333,3,317
sub-7040_ses-f1,332,728,0.456,396,792,13.2,3,318
sub-7040_ses-f2,160,720,0.2222,560,1120,18.66666667,3,319
sub-7040_ses-f3,181,720,0.2514,539,1078,17.96666667,3,320
sub-7041_ses-f1,520,754,0.6897,234,468,7.8,3,321
sub-7041_ses-f2,188,735,0.2558,547,1094,18.23333333,3,322
sub-7042_ses-f3,240,658,0.3647,418,836,13.93333333,3,323
sub-7043_ses-f2,349,1080,0.3231,731,1462,24.36666667,3,324
sub-7044_ses-f2,356,739,0.4817,383,766,12.76666667,3,325
sub-7045_ses-f1,535,823,0.6501,288,576,9.6,3,326
sub-7046_ses-f1,437,812,0.5382,375,750,12.5,3,327
sub-7046_ses-f2,30,61,0.4918,31,62,1.033333333,3,328
sub-7046_ses-f3,100,741,0.135,641,1282,21.36666667,3,329
sub-7047_ses-f1,432,720,0.6,288,576,9.6,3,330
sub-7047_ses-f2,31,64,0.4844,33,66,1.1,3,331
sub-7048_ses-f1,4,6,0.6667,2,4,0.066666667,3,332
sub-7048_ses-f2,149,360,0.4139,211,422,7.033333333,3,333
sub-7049_ses-f1,64,360,0.1778,296,592,9.866666667,3,334
sub-7052_ses-f1,94,518,0.1815,424,848,14.13333333,3,335
sub-7053_ses-f1,334,720,0.4639,386,772,12.86666667,3,336
sub-7054_ses-f1,484,766,0.6319,282,564,9.4,3,337
sub-2006_ses-T1,142,420,0.3381,278,556,9.266666667,3.2,1
sub-2011_ses-T1,115,360,0.3194,245,490,8.166666667,3.2,2
sub-2012_ses-T1,179,180,0.9944,1,2,0.033333333,3.2,3
sub-2013_ses-T1,157,360,0.4361,203,406,6.766666667,3.2,4
sub-2014_ses-T1,169,360,0.4694,191,382,6.366666667,3.2,5
sub-2015_ses-T1,11,180,0.0611,169,338,5.633333333,3.2,6
sub-2016_ses-T1,139,360,0.3861,221,442,7.366666667,3.2,7
sub-2017_ses-T1,136,180,0.7556,44,88,1.466666667,3.2,8
sub-2018_ses-T1,45,180,0.25,135,270,4.5,3.2,9
sub-2019_ses-T1,228,360,0.6333,132,264,4.4,3.2,10
sub-2020_ses-T1,17,26,0.6538,9,18,0.3,3.2,11
sub-2020_ses-T2,108,360,0.3,252,504,8.4,3.2,12
sub-2021_ses-T1,114,360,0.3167,246,492,8.2,3.2,13
sub-2022_ses-T1,169,360,0.4694,191,382,6.366666667,3.2,14
sub-2023_ses-T1,86,360,0.2389,274,548,9.133333333,3.2,15
sub-2024_ses-T2,3,12,0.25,9,18,0.3,3.2,16
sub-2026_ses-T1,87,223,0.3901,136,272,4.533333333,3.2,17
sub-2027_ses-T1,263,360,0.7306,97,194,3.233333333,3.2,18
sub-2028_ses-T1,111,360,0.3083,249,498,8.3,3.2,19
sub-2029_ses-T1,150,360,0.4167,210,420,7,3.2,20
sub-2030_ses-T1,70,360,0.1944,290,580,9.666666667,3.2,21
sub-2031_ses-T1,333,360,0.925,27,54,0.9,3.2,22
sub-2032_ses-T1,64,360,0.1778,296,592,9.866666667,3.2,23
sub-2033_ses-T1,276,360,0.7667,84,168,2.8,3.2,24
sub-2033_ses-T2,93,360,0.2583,267,534,8.9,3.2,25
sub-2034_ses-T1,5,180,0.0278,175,350,5.833333333,3.2,26
sub-2035_ses-T1,283,360,0.7861,77,154,2.566666667,3.2,27
sub-2036_ses-T1,205,360,0.5694,155,310,5.166666667,3.2,28
sub-2037_ses-T1,182,360,0.5056,178,356,5.933333333,3.2,29
sub-2038_ses-T1,299,360,0.8306,61,122,2.033333333,3.2,30
sub-2039_ses-T1,174,180,0.9667,6,12,0.2,3.2,31
sub-2040_ses-T1,236,360,0.6556,124,248,4.133333333,3.2,32
sub-2041_ses-T1,226,360,0.6278,134,268,4.466666667,3.2,33
sub-2042_ses-T1,28,180,0.1556,152,304,5.066666667,3.2,34
sub-2043_ses-T1,62,360,0.1722,298,596,9.933333333,3.2,35
sub-2044_ses-T1,89,360,0.2472,271,542,9.033333333,3.2,36
sub-2045_ses-T1,12,180,0.0667,168,336,5.6,3.2,37
sub-2046_ses-T1,98,180,0.5444,82,164,2.733333333,3.2,38
sub-2047_ses-T1,41,180,0.2278,139,278,4.633333333,3.2,39
sub-2048_ses-T1,126,180,0.7,54,108,1.8,3.2,40
sub-2049_ses-T1,208,360,0.5778,152,304,5.066666667,3.2,41
sub-2051_ses-T1,299,360,0.8306,61,122,2.033333333,3.2,42
sub-2051_ses-T2,314,360,0.8722,46,92,1.533333333,3.2,43
sub-2052_ses-T1,152,360,0.4222,208,416,6.933333333,3.2,44
sub-2052_ses-T2,33,180,0.1833,147,294,4.9,3.2,45
sub-2053_ses-T1,105,360,0.2917,255,510,8.5,3.2,46
sub-2055_ses-T1,35,180,0.1944,145,290,4.833333333,3.2,47
sub-2056_ses-T1,346,360,0.9611,14,28,0.466666667,3.2,48
sub-2057_ses-T1,185,360,0.5139,175,350,5.833333333,3.2,49
sub-2058_ses-T1,178,360,0.4944,182,364,6.066666667,3.2,50
sub-2059_ses-T1,180,360,0.5,180,360,6,3.2,51
sub-2061_ses-T1,32,180,0.1778,148,296,4.933333333,3.2,52
sub-2062_ses-T1,278,360,0.7722,82,164,2.733333333,3.2,53
sub-2063_ses-T1,108,360,0.3,252,504,8.4,3.2,54
sub-2064_ses-T1,87,180,0.4833,93,186,3.1,3.2,55
sub-2065_ses-T1,1,180,0.0056,179,358,5.966666667,3.2,56
sub-2066_ses-T1,104,180,0.5778,76,152,2.533333333,3.2,57
sub-2066_ses-T2,172,360,0.4778,188,376,6.266666667,3.2,58
sub-2067_ses-T1,154,360,0.4278,206,412,6.866666667,3.2,59
sub-2068_ses-T1,215,360,0.5972,145,290,4.833333333,3.2,60
sub-2069_ses-T1,69,360,0.1917,291,582,9.7,3.2,61
sub-2070_ses-T1,182,360,0.5056,178,356,5.933333333,3.2,62
sub-2071_ses-T1,207,360,0.575,153,306,5.1,3.2,63
sub-2072_ses-T1,241,360,0.6694,119,238,3.966666667,3.2,64
sub-2073_ses-T1,227,256,0.8867,29,58,0.966666667,3.2,65
sub-2073_ses-T2,53,180,0.2944,127,254,4.233333333,3.2,66
sub-2074_ses-T1,12,180,0.0667,168,336,5.6,3.2,67
sub-2075_ses-T1,103,180,0.5722,77,154,2.566666667,3.2,68
sub-2076_ses-T1,107,360,0.2972,253,506,8.433333333,3.2,69
sub-2076_ses-T2,49,360,0.1361,311,622,10.36666667,3.2,70
sub-2077_ses-T1,263,360,0.7306,97,194,3.233333333,3.2,71
sub-2078_ses-T1,210,360,0.5833,150,300,5,3.2,72
sub-2079_ses-T1,187,360,0.5194,173,346,5.766666667,3.2,73
sub-2079_ses-T2,69,360,0.1917,291,582,9.7,3.2,74
sub-2080_ses-T1,90,360,0.25,270,540,9,3.2,75
sub-2081_ses-T1,209,360,0.5806,151,302,5.033333333,3.2,76
sub-2082_ses-T1,115,360,0.3194,245,490,8.166666667,3.2,77
sub-2083_ses-T1,86,360,0.2389,274,548,9.133333333,3.2,78
sub-2084_ses-T1,321,360,0.8917,39,78,1.3,3.2,79
sub-2085_ses-T1,150,360,0.4167,210,420,7,3.2,80
sub-2086_ses-T1,29,360,0.0806,331,662,11.03333333,3.2,81
sub-2087_ses-T1,324,360,0.9,36,72,1.2,3.2,82
sub-2088_ses-T1,188,360,0.5222,172,344,5.733333333,3.2,83
sub-2089_ses-T1,148,180,0.8222,32,64,1.066666667,3.2,84
sub-2091_ses-T1,68,360,0.1889,292,584,9.733333333,3.2,85
sub-2092_ses-T1,198,360,0.55,162,324,5.4,3.2,86
sub-2093_ses-T1,198,360,0.55,162,324,5.4,3.2,87
sub-2094_ses-T1,165,180,0.9167,15,30,0.5,3.2,88
sub-2095_ses-T1,198,360,0.55,162,324,5.4,3.2,89
sub-2096_ses-T1,173,360,0.4806,187,374,6.233333333,3.2,90
sub-2097_ses-T1,348,540,0.6444,192,384,6.4,3.2,91
sub-2098_ses-T1,60,360,0.1667,300,600,10,3.2,92
sub-2099_ses-T1,53,180,0.2944,127,254,4.233333333,3.2,93
sub-2099_ses-T2,83,360,0.2306,277,554,9.233333333,3.2,94
sub-2100_ses-T1,97,180,0.5389,83,166,2.766666667,3.2,95
sub-2100_ses-T2,84,360,0.2333,276,552,9.2,3.2,96
sub-2101_ses-T1,171,360,0.475,189,378,6.3,3.2,97
sub-2101_ses-T2,121,360,0.3361,239,478,7.966666667,3.2,98
sub-2102_ses-T1,198,360,0.55,162,324,5.4,3.2,99
sub-2103_ses-T1,147,360,0.4083,213,426,7.1,3.2,100
sub-2103_ses-T2,241,360,0.6694,119,238,3.966666667,3.2,101
sub-2104_ses-T1,276,387,0.7132,111,222,3.7,3.2,102
sub-2105_ses-T1,233,360,0.6472,127,254,4.233333333,3.2,103
sub-2105_ses-T2,234,360,0.65,126,252,4.2,3.2,104
sub-2106_ses-T1,265,360,0.7361,95,190,3.166666667,3.2,105
sub-2107_ses-T1,97,360,0.2694,263,526,8.766666667,3.2,106
sub-2107_ses-T2,137,360,0.3806,223,446,7.433333333,3.2,107
sub-2108_ses-T1,310,360,0.8611,50,100,1.666666667,3.2,108
sub-2108_ses-T3,91,141,0.6454,50,100,1.666666667,3.2,109
sub-2109_ses-T1,78,180,0.4333,102,204,3.4,3.2,110
sub-2110_ses-T1,206,274,0.7518,68,136,2.266666667,3.2,111
sub-2115_ses-T1,216,360,0.6,144,288,4.8,3.2,112
sub-2115_ses-T2,132,360,0.3667,228,456,7.6,3.2,113
sub-2117_ses-T1,180,360,0.5,180,360,6,3.2,114
sub-2117_ses-T2,63,360,0.175,297,594,9.9,3.2,115
sub-2118_ses-T1,131,360,0.3639,229,458,7.633333333,3.2,116
sub-2120_ses-T1,182,360,0.5056,178,356,5.933333333,3.2,117
sub-2122_ses-T1,197,360,0.5472,163,326,5.433333333,3.2,118
sub-2123_ses-T1,303,360,0.8417,57,114,1.9,3.2,119
sub-2124_ses-T1,334,404,0.8267,70,140,2.333333333,3.2,120
sub-2126_ses-T1,209,360,0.5806,151,302,5.033333333,3.2,121
sub-2128_ses-T1,220,360,0.6111,140,280,4.666666667,3.2,122
sub-2133_ses-T1,151,360,0.4194,209,418,6.966666667,3.2,123
sub-2135_ses-T1,7,19,0.3684,12,24,0.4,3.2,124
sub-2136_ses-T1,319,720,0.4431,401,802,13.36666667,3.2,125
sub-2137_ses-T1,227,720,0.3153,493,986,16.43333333,3.2,126
sub-2137_ses-T2,107,360,0.2972,253,506,8.433333333,3.2,127
sub-2138_ses-T1,263,360,0.7306,97,194,3.233333333,3.2,128
sub-2139_ses-T1,78,360,0.2167,282,564,9.4,3.2,129
sub-2140_ses-T1,377,379,0.9947,2,4,0.066666667,3.2,130
sub-2141_ses-T1,135,360,0.375,225,450,7.5,3.2,131
sub-2142_ses-T2,288,360,0.8,72,144,2.4,3.2,132
sub-2143_ses-T1,173,360,0.4806,187,374,6.233333333,3.2,133
sub-2144_ses-T1,194,372,0.5215,178,356,5.933333333,3.2,134
sub-2145_ses-T1,180,360,0.5,180,360,6,3.2,135
sub-2145_ses-T2,50,360,0.1389,310,620,10.33333333,3.2,136
sub-2146_ses-T1,272,360,0.7556,88,176,2.933333333,3.2,137
sub-2146_ses-T2,272,720,0.3778,448,896,14.93333333,3.2,138
sub-2147_ses-T1,134,360,0.3722,226,452,7.533333333,3.2,139
sub-2147_ses-T2,163,360,0.4528,197,394,6.566666667,3.2,140
sub-2148_ses-T1,325,399,0.8145,74,148,2.466666667,3.2,141
sub-2149_ses-T1,185,360,0.5139,175,350,5.833333333,3.2,142
sub-2150_ses-T1,296,360,0.8222,64,128,2.133333333,3.2,143
sub-2150_ses-T2,172,360,0.4778,188,376,6.266666667,3.2,144
sub-2151_ses-T1,270,720,0.375,450,900,15,3.2,145
sub-2151_ses-T2,401,773,0.5188,372,744,12.4,3.2,146
sub-2152_ses-T1,305,360,0.8472,55,110,1.833333333,3.2,147
sub-2152_ses-T2,139,360,0.3861,221,442,7.366666667,3.2,148
sub-2153_ses-T1,293,383,0.765,90,180,3,3.2,149
sub-2154_ses-T2,268,360,0.7444,92,184,3.066666667,3.2,150
sub-2155_ses-T1,146,360,0.4056,214,428,7.133333333,3.2,151
sub-2156_ses-T1,116,360,0.3222,244,488,8.133333333,3.2,152
sub-2157_ses-T1,247,360,0.6861,113,226,3.766666667,3.2,153
sub-2158_ses-T1,200,360,0.5556,160,320,5.333333333,3.2,154
sub-2159_ses-T1,129,360,0.3583,231,462,7.7,3.2,155
sub-2160_ses-T1,80,360,0.2222,280,560,9.333333333,3.2,156
sub-2161_ses-T1,203,360,0.5639,157,314,5.233333333,3.2,157
sub-2162_ses-T1,241,360,0.6694,119,238,3.966666667,3.2,158
sub-2163_ses-T1,290,399,0.7268,109,218,3.633333333,3.2,159
sub-2164_ses-T1,146,720,0.2028,574,1148,19.13333333,3.2,160
sub-2164_ses-T2,321,720,0.4458,399,798,13.3,3.2,161
sub-2165_ses-T1,190,481,0.395,291,582,9.7,3.2,162
sub-2166_ses-T1,213,360,0.5917,147,294,4.9,3.2,163
sub-2166_ses-T2,170,360,0.4722,190,380,6.333333333,3.2,164
sub-2167_ses-T1,273,370,0.7378,97,194,3.233333333,3.2,165
sub-2168_ses-T1,250,360,0.6944,110,220,3.666666667,3.2,166
sub-2168_ses-T2,190,360,0.5278,170,340,5.666666667,3.2,167
sub-2169_ses-T1,238,360,0.6611,122,244,4.066666667,3.2,168
sub-2169_ses-T2,140,360,0.3889,220,440,7.333333333,3.2,169
sub-2170_ses-T1,112,264,0.4242,152,304,5.066666667,3.2,170
sub-2171_ses-T1,275,374,0.7353,99,198,3.3,3.2,171
sub-2171_ses-T2,192,483,0.3975,291,582,9.7,3.2,172
sub-2171_ses-T3,133,577,0.2305,444,888,14.8,3.2,173
sub-2172_ses-T1,177,513,0.345,336,672,11.2,3.2,174
sub-2172_ses-T2,275,386,0.7124,111,222,3.7,3.2,175
sub-2173_ses-T1,100,360,0.2778,260,520,8.666666667,3.2,176
sub-2174_ses-T1,182,416,0.4375,234,468,7.8,3.2,177
sub-2175_ses-T1,482,679,0.7099,197,394,6.566666667,3.2,178
sub-2176_ses-T1,109,360,0.3028,251,502,8.366666667,3.2,179
sub-2176_ses-T2,0,360,0,360,720,12,3.2,180
sub-2177_ses-T1,621,695,0.8935,74,148,2.466666667,3.2,181
sub-2177_ses-T2,323,736,0.4389,413,826,13.76666667,3.2,182
sub-2178_ses-T2,103,360,0.2861,257,514,8.566666667,3.2,183
sub-2179_ses-T2,316,720,0.4389,404,808,13.46666667,3.2,184
sub-2180_ses-T1,133,360,0.3694,227,454,7.566666667,3.2,185
sub-2180_ses-T2,31,360,0.0861,329,658,10.96666667,3.2,186
sub-2181_ses-T1,267,360,0.7417,93,186,3.1,3.2,187
sub-2182_ses-T1,30,51,0.5882,21,42,0.7,3.2,188
sub-2184_ses-T1,260,391,0.665,131,262,4.366666667,3.2,189
sub-2185_ses-T1,207,360,0.575,153,306,5.1,3.2,190
sub-2186_ses-T1,48,371,0.1294,323,646,10.76666667,3.2,191
sub-2187_ses-T1,37,48,0.7708,11,22,0.366666667,3.2,192
sub-2188_ses-T1,345,445,0.7753,100,200,3.333333333,3.2,193
sub-2189_ses-T1,169,204,0.8284,35,70,1.166666667,3.2,194
sub-2190_ses-T1,168,360,0.4667,192,384,6.4,3.2,195
sub-2191_ses-T1,247,360,0.6861,113,226,3.766666667,3.2,196
sub-2191_ses-T2,1,360,0.0028,359,718,11.96666667,3.2,197
sub-2192_ses-T1,239,360,0.6639,121,242,4.033333333,3.2,198
sub-2193_ses-T2,433,625,0.6928,192,384,6.4,3.2,199
sub-2194_ses-T1,239,415,0.5759,176,352,5.866666667,3.2,200
sub-2195_ses-T1,59,360,0.1639,301,602,10.03333333,3.2,201
sub-2196_ses-T1,105,416,0.2524,311,622,10.36666667,3.2,202
sub-2197_ses-T1,300,439,0.6834,139,278,4.633333333,3.2,203
sub-2197_ses-T2,91,384,0.237,293,586,9.766666667,3.2,204
sub-2198_ses-T1,246,407,0.6044,161,322,5.366666667,3.2,205
sub-2199_ses-T1,251,404,0.6213,153,306,5.1,3.2,206
sub-2200_ses-T1,113,360,0.3139,247,494,8.233333333,3.2,207
sub-2201_ses-T1,231,360,0.6417,129,258,4.3,3.2,208
sub-2202_ses-T1,144,606,0.2376,462,924,15.4,3.2,209
sub-2203_ses-T1,124,360,0.3444,236,472,7.866666667,3.2,210
sub-2204_ses-T1,222,360,0.6167,138,276,4.6,3.2,211
sub-2204_ses-T2,221,360,0.6139,139,278,4.633333333,3.2,212
sub-2205_ses-T1,162,360,0.45,198,396,6.6,3.2,213
sub-2206_ses-T1,278,360,0.7722,82,164,2.733333333,3.2,214
sub-2206_ses-T2,240,720,0.3333,480,960,16,3.2,215
sub-2207_ses-T1,62,360,0.1722,298,596,9.933333333,3.2,216
sub-2207_ses-T2,71,360,0.1972,289,578,9.633333333,3.2,217
sub-2208_ses-T1,252,360,0.7,108,216,3.6,3.2,218
sub-2208_ses-T2,138,360,0.3833,222,444,7.4,3.2,219
sub-2209_ses-T1,208,341,0.61,133,266,4.433333333,3.2,220
sub-2210_ses-T1,25,38,0.6579,13,26,0.433333333,3.2,221
sub-2211_ses-T1,212,360,0.5889,148,296,4.933333333,3.2,222
sub-2212_ses-T1,249,360,0.6917,111,222,3.7,3.2,223
sub-2213_ses-T1,112,286,0.3916,174,348,5.8,3.2,224
sub-2214_ses-T1,309,373,0.8284,64,128,2.133333333,3.2,225
sub-2215_ses-T1,241,360,0.6694,119,238,3.966666667,3.2,226
sub-2216_ses-T1,22,86,0.2558,64,128,2.133333333,3.2,227
sub-2216_ses-T2,67,181,0.3702,114,228,3.8,3.2,228
sub-2217_ses-T1,71,360,0.1972,289,578,9.633333333,3.2,229
sub-2217_ses-T2,16,360,0.0444,344,688,11.46666667,3.2,230
sub-2218_ses-T1,136,360,0.3778,224,448,7.466666667,3.2,231
sub-2218_ses-T2,144,720,0.2,576,1152,19.2,3.2,232
sub-2219_ses-T1,310,360,0.8611,50,100,1.666666667,3.2,233
sub-2220_ses-T1,273,360,0.7583,87,174,2.9,3.2,234
sub-2220_ses-T2,32,720,0.0444,688,1376,22.93333333,3.2,235
sub-2221_ses-T1,69,360,0.1917,291,582,9.7,3.2,236
sub-2221_ses-T2,294,720,0.4083,426,852,14.2,3.2,237
sub-2222_ses-T1,121,360,0.3361,239,478,7.966666667,3.2,238
sub-2223_ses-T1,194,360,0.5389,166,332,5.533333333,3.2,239
sub-2223_ses-T2,204,720,0.2833,516,1032,17.2,3.2,240
sub-2224_ses-T1,150,379,0.3958,229,458,7.633333333,3.2,241
sub-2225_ses-T1,228,360,0.6333,132,264,4.4,3.2,242
sub-2225_ses-T2,213,759,0.2806,546,1092,18.2,3.2,243
sub-2226_ses-T1,89,365,0.2438,276,552,9.2,3.2,244
sub-2226_ses-T2,40,360,0.1111,320,640,10.66666667,3.2,245
sub-2227_ses-T1,192,360,0.5333,168,336,5.6,3.2,246
sub-2228_ses-T1,229,360,0.6361,131,262,4.366666667,3.2,247
sub-2228_ses-T2,247,729,0.3388,482,964,16.06666667,3.2,248
sub-2229_ses-T1,297,360,0.825,63,126,2.1,3.2,249
sub-2229_ses-T2,59,390,0.1513,331,662,11.03333333,3.2,250
sub-2230_ses-T1,304,398,0.7638,94,188,3.133333333,3.2,251
sub-7001_ses-f2,176,720,0.2444,544,1088,18.13333333,3.2,252
sub-7001_ses-f3,45,720,0.0625,675,1350,22.5,3.2,253
sub-7002_ses-f1,166,720,0.2306,554,1108,18.46666667,3.2,254
sub-7002_ses-f2,259,720,0.3597,461,922,15.36666667,3.2,255
sub-7003_ses-f1,73,360,0.2028,287,574,9.566666667,3.2,256
sub-7003_ses-f2,5,180,0.0278,175,350,5.833333333,3.2,257
sub-7004_ses-f3,277,724,0.3826,447,894,14.9,3.2,258
sub-7006_ses-f1,31,52,0.5962,21,42,0.7,3.2,259
sub-7008_ses-f1,366,720,0.5083,354,708,11.8,3.2,260
sub-7008_ses-f2,83,720,0.1153,637,1274,21.23333333,3.2,261
sub-7009_ses-f1,297,720,0.4125,423,846,14.1,3.2,262
sub-7009_ses-f2,171,720,0.2375,549,1098,18.3,3.2,263
sub-7011_ses-f1,850,917,0.9269,67,134,2.233333333,3.2,264
sub-7011_ses-f2,98,360,0.2722,262,524,8.733333333,3.2,265
sub-7012_ses-f1,623,761,0.8187,138,276,4.6,3.2,266
sub-7012_ses-f2,338,720,0.4694,382,764,12.73333333,3.2,267
sub-7014_ses-f1,56,360,0.1556,304,608,10.13333333,3.2,268
sub-7014_ses-f2,277,720,0.3847,443,886,14.76666667,3.2,269
sub-7015_ses-f1,596,832,0.7163,236,472,7.866666667,3.2,270
sub-7015_ses-f2,251,729,0.3443,478,956,15.93333333,3.2,271
sub-7016_ses-f1,357,750,0.476,393,786,13.1,3.2,272
sub-7016_ses-f2,74,720,0.1028,646,1292,21.53333333,3.2,273
sub-7017_ses-f1,642,740,0.8676,98,196,3.266666667,3.2,274
sub-7017_ses-f2,459,725,0.6331,266,532,8.866666667,3.2,275
sub-7020_ses-f1,166,740,0.2243,574,1148,19.13333333,3.2,276
sub-7020_ses-f2,156,720,0.2167,564,1128,18.8,3.2,277
sub-7021_ses-f1,624,753,0.8287,129,258,4.3,3.2,278
sub-7022_ses-f1,562,720,0.7806,158,316,5.266666667,3.2,279
sub-7022_ses-f2,361,727,0.4966,366,732,12.2,3.2,280
sub-7023_ses-f1,383,744,0.5148,361,722,12.03333333,3.2,281
sub-7023_ses-f2,444,829,0.5356,385,770,12.83333333,3.2,282
sub-7024_ses-f1,523,728,0.7184,205,410,6.833333333,3.2,283
sub-7025_ses-f1,218,729,0.299,511,1022,17.03333333,3.2,284
sub-7025_ses-f2,143,760,0.1882,617,1234,20.56666667,3.2,285
sub-7026_ses-f1,514,920,0.5587,406,812,13.53333333,3.2,286
sub-7026_ses-f2,514,914,0.5624,400,800,13.33333333,3.2,287
sub-7026_ses-f3,85,731,0.1163,646,1292,21.53333333,3.2,288
sub-7027_ses-f1,769,885,0.8689,116,232,3.866666667,3.2,289
sub-7027_ses-f2,91,410,0.222,319,638,10.63333333,3.2,290
sub-7027_ses-f3,69,725,0.0952,656,1312,21.86666667,3.2,291
sub-7028_ses-f1,701,752,0.9322,51,102,1.7,3.2,292
sub-7028_ses-f2,497,720,0.6903,223,446,7.433333333,3.2,293
sub-7029_ses-f1,325,731,0.4446,406,812,13.53333333,3.2,294
sub-7029_ses-f2,229,725,0.3159,496,992,16.53333333,3.2,295
sub-7030_ses-f1,422,720,0.5861,298,596,9.933333333,3.2,296
sub-7030_ses-f2,221,794,0.2783,573,1146,19.1,3.2,297
sub-7031_ses-f1,11,192,0.0573,181,362,6.033333333,3.2,298
sub-7031_ses-f2,8,374,0.0214,366,732,12.2,3.2,299
sub-7031_ses-f3,275,737,0.3731,462,924,15.4,3.2,300
sub-7032_ses-f1,685,720,0.9514,35,70,1.166666667,3.2,301
sub-7032_ses-f2,38,73,0.5205,35,70,1.166666667,3.2,302
sub-7032_ses-f3,422,740,0.5703,318,636,10.6,3.2,303
sub-7033_ses-f2,265,752,0.3524,487,974,16.23333333,3.2,304
sub-7034_ses-f1,572,760,0.7526,188,376,6.266666667,3.2,305
sub-7034_ses-f2,454,912,0.4978,458,916,15.26666667,3.2,306
sub-7034_ses-f3,92,728,0.1264,636,1272,21.2,3.2,307
sub-7035_ses-f1,11,50,0.22,39,78,1.3,3.2,308
sub-7035_ses-f2,99,727,0.1362,628,1256,20.93333333,3.2,309
sub-7036_ses-f1,207,745,0.2779,538,1076,17.93333333,3.2,310
sub-7037_ses-f1,726,772,0.9404,46,92,1.533333333,3.2,311
sub-7037_ses-f2,637,852,0.7477,215,430,7.166666667,3.2,312
sub-7037_ses-f3,151,720,0.2097,569,1138,18.96666667,3.2,313
sub-7038_ses-f1,444,789,0.5627,345,690,11.5,3.2,314
sub-7038_ses-f2,230,785,0.293,555,1110,18.5,3.2,315
sub-7039_ses-f1,382,785,0.4866,403,806,13.43333333,3.2,316
sub-7039_ses-f2,199,727,0.2737,528,1056,17.6,3.2,317
sub-7040_ses-f1,313,728,0.4299,415,830,13.83333333,3.2,318
sub-7040_ses-f2,146,720,0.2028,574,1148,19.13333333,3.2,319
sub-7040_ses-f3,167,720,0.2319,553,1106,18.43333333,3.2,320
sub-7041_ses-f1,508,754,0.6737,246,492,8.2,3.2,321
sub-7041_ses-f2,177,735,0.2408,558,1116,18.6,3.2,322
sub-7042_ses-f3,227,658,0.345,431,862,14.36666667,3.2,323
sub-7043_ses-f2,339,1080,0.3139,741,1482,24.7,3.2,324
sub-7044_ses-f2,339,739,0.4587,400,800,13.33333333,3.2,325
sub-7045_ses-f1,496,823,0.6027,327,654,10.9,3.2,326
sub-7046_ses-f1,400,812,0.4926,412,824,13.73333333,3.2,327
sub-7046_ses-f2,30,61,0.4918,31,62,1.033333333,3.2,328
sub-7046_ses-f3,89,741,0.1201,652,1304,21.73333333,3.2,329
sub-7047_ses-f1,401,720,0.5569,319,638,10.63333333,3.2,330
sub-7047_ses-f2,31,64,0.4844,33,66,1.1,3.2,331
sub-7048_ses-f1,4,6,0.6667,2,4,0.066666667,3.2,332
sub-7048_ses-f2,143,360,0.3972,217,434,7.233333333,3.2,333
sub-7049_ses-f1,61,360,0.1694,299,598,9.966666667,3.2,334
sub-7052_ses-f1,89,518,0.1718,429,858,14.3,3.2,335
sub-7053_ses-f1,309,720,0.4292,411,822,13.7,3.2,336
sub-7054_ses-f1,476,766,0.6214,290,580,9.666666667,3.2,337
sub-2006_ses-T1,137,420,0.3262,283,566,9.433333333,3.4,1
sub-2011_ses-T1,111,360,0.3083,249,498,8.3,3.4,2
sub-2012_ses-T1,179,180,0.9944,1,2,0.033333333,3.4,3
sub-2013_ses-T1,150,360,0.4167,210,420,7,3.4,4
sub-2014_ses-T1,152,360,0.4222,208,416,6.933333333,3.4,5
sub-2015_ses-T1,9,180,0.05,171,342,5.7,3.4,6
sub-2016_ses-T1,131,360,0.3639,229,458,7.633333333,3.4,7
sub-2017_ses-T1,132,180,0.7333,48,96,1.6,3.4,8
sub-2018_ses-T1,41,180,0.2278,139,278,4.633333333,3.4,9
sub-2019_ses-T1,216,360,0.6,144,288,4.8,3.4,10
sub-2020_ses-T1,17,26,0.6538,9,18,0.3,3.4,11
sub-2020_ses-T2,98,360,0.2722,262,524,8.733333333,3.4,12
sub-2021_ses-T1,106,360,0.2944,254,508,8.466666667,3.4,13
sub-2022_ses-T1,166,360,0.4611,194,388,6.466666667,3.4,14
sub-2023_ses-T1,79,360,0.2194,281,562,9.366666667,3.4,15
sub-2024_ses-T2,3,12,0.25,9,18,0.3,3.4,16
sub-2026_ses-T1,81,223,0.3632,142,284,4.733333333,3.4,17
sub-2027_ses-T1,255,360,0.7083,105,210,3.5,3.4,18
sub-2028_ses-T1,103,360,0.2861,257,514,8.566666667,3.4,19
sub-2029_ses-T1,139,360,0.3861,221,442,7.366666667,3.4,20
sub-2030_ses-T1,67,360,0.1861,293,586,9.766666667,3.4,21
sub-2031_ses-T1,328,360,0.9111,32,64,1.066666667,3.4,22
sub-2032_ses-T1,62,360,0.1722,298,596,9.933333333,3.4,23
sub-2033_ses-T1,261,360,0.725,99,198,3.3,3.4,24
sub-2033_ses-T2,87,360,0.2417,273,546,9.1,3.4,25
sub-2034_ses-T1,5,180,0.0278,175,350,5.833333333,3.4,26
sub-2035_ses-T1,274,360,0.7611,86,172,2.866666667,3.4,27
sub-2036_ses-T1,195,360,0.5417,165,330,5.5,3.4,28
sub-2037_ses-T1,161,360,0.4472,199,398,6.633333333,3.4,29
sub-2038_ses-T1,291,360,0.8083,69,138,2.3,3.4,30
sub-2039_ses-T1,174,180,0.9667,6,12,0.2,3.4,31
sub-2040_ses-T1,227,360,0.6306,133,266,4.433333333,3.4,32
sub-2041_ses-T1,205,360,0.5694,155,310,5.166666667,3.4,33
sub-2042_ses-T1,27,180,0.15,153,306,5.1,3.4,34
sub-2043_ses-T1,60,360,0.1667,300,600,10,3.4,35
sub-2044_ses-T1,81,360,0.225,279,558,9.3,3.4,36
sub-2045_ses-T1,10,180,0.0556,170,340,5.666666667,3.4,37
sub-2046_ses-T1,92,180,0.5111,88,176,2.933333333,3.4,38
sub-2047_ses-T1,34,180,0.1889,146,292,4.866666667,3.4,39
sub-2048_ses-T1,119,180,0.6611,61,122,2.033333333,3.4,40
sub-2049_ses-T1,199,360,0.5528,161,322,5.366666667,3.4,41
sub-2051_ses-T1,293,360,0.8139,67,134,2.233333333,3.4,42
sub-2051_ses-T2,310,360,0.8611,50,100,1.666666667,3.4,43
sub-2052_ses-T1,147,360,0.4083,213,426,7.1,3.4,44
sub-2052_ses-T2,32,180,0.1778,148,296,4.933333333,3.4,45
sub-2053_ses-T1,104,360,0.2889,256,512,8.533333333,3.4,46
sub-2055_ses-T1,35,180,0.1944,145,290,4.833333333,3.4,47
sub-2056_ses-T1,343,360,0.9528,17,34,0.566666667,3.4,48
sub-2057_ses-T1,176,360,0.4889,184,368,6.133333333,3.4,49
sub-2058_ses-T1,171,360,0.475,189,378,6.3,3.4,50
sub-2059_ses-T1,178,360,0.4944,182,364,6.066666667,3.4,51
sub-2061_ses-T1,30,180,0.1667,150,300,5,3.4,52
sub-2062_ses-T1,272,360,0.7556,88,176,2.933333333,3.4,53
sub-2063_ses-T1,98,360,0.2722,262,524,8.733333333,3.4,54
sub-2064_ses-T1,79,180,0.4389,101,202,3.366666667,3.4,55
sub-2065_ses-T1,1,180,0.0056,179,358,5.966666667,3.4,56
sub-2066_ses-T1,95,180,0.5278,85,170,2.833333333,3.4,57
sub-2066_ses-T2,159,360,0.4417,201,402,6.7,3.4,58
sub-2067_ses-T1,142,360,0.3944,218,436,7.266666667,3.4,59
sub-2068_ses-T1,202,360,0.5611,158,316,5.266666667,3.4,60
sub-2069_ses-T1,60,360,0.1667,300,600,10,3.4,61
sub-2070_ses-T1,167,360,0.4639,193,386,6.433333333,3.4,62
sub-2071_ses-T1,200,360,0.5556,160,320,5.333333333,3.4,63
sub-2072_ses-T1,230,360,0.6389,130,260,4.333333333,3.4,64
sub-2073_ses-T1,224,256,0.875,32,64,1.066666667,3.4,65
sub-2073_ses-T2,51,180,0.2833,129,258,4.3,3.4,66
sub-2074_ses-T1,12,180,0.0667,168,336,5.6,3.4,67
sub-2075_ses-T1,99,180,0.55,81,162,2.7,3.4,68
sub-2076_ses-T1,103,360,0.2861,257,514,8.566666667,3.4,69
sub-2076_ses-T2,45,360,0.125,315,630,10.5,3.4,70
sub-2077_ses-T1,244,360,0.6778,116,232,3.866666667,3.4,71
sub-2078_ses-T1,187,360,0.5194,173,346,5.766666667,3.4,72
sub-2079_ses-T1,182,360,0.5056,178,356,5.933333333,3.4,73
sub-2079_ses-T2,64,360,0.1778,296,592,9.866666667,3.4,74
sub-2080_ses-T1,84,360,0.2333,276,552,9.2,3.4,75
sub-2081_ses-T1,192,360,0.5333,168,336,5.6,3.4,76
sub-2082_ses-T1,108,360,0.3,252,504,8.4,3.4,77
sub-2083_ses-T1,83,360,0.2306,277,554,9.233333333,3.4,78
sub-2084_ses-T1,314,360,0.8722,46,92,1.533333333,3.4,79
sub-2085_ses-T1,138,360,0.3833,222,444,7.4,3.4,80
sub-2086_ses-T1,22,360,0.0611,338,676,11.26666667,3.4,81
sub-2087_ses-T1,321,360,0.8917,39,78,1.3,3.4,82
sub-2088_ses-T1,173,360,0.4806,187,374,6.233333333,3.4,83
sub-2089_ses-T1,142,180,0.7889,38,76,1.266666667,3.4,84
sub-2091_ses-T1,61,360,0.1694,299,598,9.966666667,3.4,85
sub-2092_ses-T1,191,360,0.5306,169,338,5.633333333,3.4,86
sub-2093_ses-T1,192,360,0.5333,168,336,5.6,3.4,87
sub-2094_ses-T1,162,180,0.9,18,36,0.6,3.4,88
sub-2095_ses-T1,179,360,0.4972,181,362,6.033333333,3.4,89
sub-2096_ses-T1,161,360,0.4472,199,398,6.633333333,3.4,90
sub-2097_ses-T1,331,540,0.613,209,418,6.966666667,3.4,91
sub-2098_ses-T1,57,360,0.1583,303,606,10.1,3.4,92
sub-2099_ses-T1,45,180,0.25,135,270,4.5,3.4,93
sub-2099_ses-T2,77,360,0.2139,283,566,9.433333333,3.4,94
sub-2100_ses-T1,95,180,0.5278,85,170,2.833333333,3.4,95
sub-2100_ses-T2,82,360,0.2278,278,556,9.266666667,3.4,96
sub-2101_ses-T1,163,360,0.4528,197,394,6.566666667,3.4,97
sub-2101_ses-T2,120,360,0.3333,240,480,8,3.4,98
sub-2102_ses-T1,183,360,0.5083,177,354,5.9,3.4,99
sub-2103_ses-T1,137,360,0.3806,223,446,7.433333333,3.4,100
sub-2103_ses-T2,223,360,0.6194,137,274,4.566666667,3.4,101
sub-2104_ses-T1,268,387,0.6925,119,238,3.966666667,3.4,102
sub-2105_ses-T1,225,360,0.625,135,270,4.5,3.4,103
sub-2105_ses-T2,225,360,0.625,135,270,4.5,3.4,104
sub-2106_ses-T1,259,360,0.7194,101,202,3.366666667,3.4,105
sub-2107_ses-T1,91,360,0.2528,269,538,8.966666667,3.4,106
sub-2107_ses-T2,126,360,0.35,234,468,7.8,3.4,107
sub-2108_ses-T1,305,360,0.8472,55,110,1.833333333,3.4,108
sub-2108_ses-T3,90,141,0.6383,51,102,1.7,3.4,109
sub-2109_ses-T1,65,180,0.3611,115,230,3.833333333,3.4,110
sub-2110_ses-T1,203,274,0.7409,71,142,2.366666667,3.4,111
sub-2115_ses-T1,209,360,0.5806,151,302,5.033333333,3.4,112
sub-2115_ses-T2,120,360,0.3333,240,480,8,3.4,113
sub-2117_ses-T1,166,360,0.4611,194,388,6.466666667,3.4,114
sub-2117_ses-T2,56,360,0.1556,304,608,10.13333333,3.4,115
sub-2118_ses-T1,123,360,0.3417,237,474,7.9,3.4,116
sub-2120_ses-T1,170,360,0.4722,190,380,6.333333333,3.4,117
sub-2122_ses-T1,189,360,0.525,171,342,5.7,3.4,118
sub-2123_ses-T1,297,360,0.825,63,126,2.1,3.4,119
sub-2124_ses-T1,334,404,0.8267,70,140,2.333333333,3.4,120
sub-2126_ses-T1,195,360,0.5417,165,330,5.5,3.4,121
sub-2128_ses-T1,214,360,0.5944,146,292,4.866666667,3.4,122
sub-2133_ses-T1,144,360,0.4,216,432,7.2,3.4,123
sub-2135_ses-T1,7,19,0.3684,12,24,0.4,3.4,124
sub-2136_ses-T1,303,720,0.4208,417,834,13.9,3.4,125
sub-2137_ses-T1,199,720,0.2764,521,1042,17.36666667,3.4,126
sub-2137_ses-T2,106,360,0.2944,254,508,8.466666667,3.4,127
sub-2138_ses-T1,249,360,0.6917,111,222,3.7,3.4,128
sub-2139_ses-T1,74,360,0.2056,286,572,9.533333333,3.4,129
sub-2140_ses-T1,376,379,0.9921,3,6,0.1,3.4,130
sub-2141_ses-T1,131,360,0.3639,229,458,7.633333333,3.4,131
sub-2142_ses-T2,282,360,0.7833,78,156,2.6,3.4,132
sub-2143_ses-T1,166,360,0.4611,194,388,6.466666667,3.4,133
sub-2144_ses-T1,182,372,0.4892,190,380,6.333333333,3.4,134
sub-2145_ses-T1,176,360,0.4889,184,368,6.133333333,3.4,135
sub-2145_ses-T2,49,360,0.1361,311,622,10.36666667,3.4,136
sub-2146_ses-T1,262,360,0.7278,98,196,3.266666667,3.4,137
sub-2146_ses-T2,254,720,0.3528,466,932,15.53333333,3.4,138
sub-2147_ses-T1,110,360,0.3056,250,500,8.333333333,3.4,139
sub-2147_ses-T2,141,360,0.3917,219,438,7.3,3.4,140
sub-2148_ses-T1,319,399,0.7995,80,160,2.666666667,3.4,141
sub-2149_ses-T1,177,360,0.4917,183,366,6.1,3.4,142
sub-2150_ses-T1,286,360,0.7944,74,148,2.466666667,3.4,143
sub-2150_ses-T2,167,360,0.4639,193,386,6.433333333,3.4,144
sub-2151_ses-T1,246,720,0.3417,474,948,15.8,3.4,145
sub-2151_ses-T2,391,773,0.5058,382,764,12.73333333,3.4,146
sub-2152_ses-T1,303,360,0.8417,57,114,1.9,3.4,147
sub-2152_ses-T2,131,360,0.3639,229,458,7.633333333,3.4,148
sub-2153_ses-T1,284,383,0.7415,99,198,3.3,3.4,149
sub-2154_ses-T2,262,360,0.7278,98,196,3.266666667,3.4,150
sub-2155_ses-T1,136,360,0.3778,224,448,7.466666667,3.4,151
sub-2156_ses-T1,110,360,0.3056,250,500,8.333333333,3.4,152
sub-2157_ses-T1,225,360,0.625,135,270,4.5,3.4,153
sub-2158_ses-T1,194,360,0.5389,166,332,5.533333333,3.4,154
sub-2159_ses-T1,121,360,0.3361,239,478,7.966666667,3.4,155
sub-2160_ses-T1,75,360,0.2083,285,570,9.5,3.4,156
sub-2161_ses-T1,195,360,0.5417,165,330,5.5,3.4,157
sub-2162_ses-T1,229,360,0.6361,131,262,4.366666667,3.4,158
sub-2163_ses-T1,285,399,0.7143,114,228,3.8,3.4,159
sub-2164_ses-T1,140,720,0.1944,580,1160,19.33333333,3.4,160
sub-2164_ses-T2,309,720,0.4292,411,822,13.7,3.4,161
sub-2165_ses-T1,182,481,0.3784,299,598,9.966666667,3.4,162
sub-2166_ses-T1,210,360,0.5833,150,300,5,3.4,163
sub-2166_ses-T2,169,360,0.4694,191,382,6.366666667,3.4,164
sub-2167_ses-T1,260,370,0.7027,110,220,3.666666667,3.4,165
sub-2168_ses-T1,240,360,0.6667,120,240,4,3.4,166
sub-2168_ses-T2,180,360,0.5,180,360,6,3.4,167
sub-2169_ses-T1,220,360,0.6111,140,280,4.666666667,3.4,168
sub-2169_ses-T2,137,360,0.3806,223,446,7.433333333,3.4,169
sub-2170_ses-T1,105,264,0.3977,159,318,5.3,3.4,170
sub-2171_ses-T1,273,374,0.7299,101,202,3.366666667,3.4,171
sub-2171_ses-T2,182,483,0.3768,301,602,10.03333333,3.4,172
sub-2171_ses-T3,128,577,0.2218,449,898,14.96666667,3.4,173
sub-2172_ses-T1,164,513,0.3197,349,698,11.63333333,3.4,174
sub-2172_ses-T2,264,386,0.6839,122,244,4.066666667,3.4,175
sub-2173_ses-T1,97,360,0.2694,263,526,8.766666667,3.4,176
sub-2174_ses-T1,173,416,0.4159,243,486,8.1,3.4,177
sub-2175_ses-T1,462,679,0.6804,217,434,7.233333333,3.4,178
sub-2176_ses-T1,102,360,0.2833,258,516,8.6,3.4,179
sub-2176_ses-T2,0,360,0,360,720,12,3.4,180
sub-2177_ses-T1,610,695,0.8777,85,170,2.833333333,3.4,181
sub-2177_ses-T2,288,736,0.3913,448,896,14.93333333,3.4,182
sub-2178_ses-T2,96,360,0.2667,264,528,8.8,3.4,183
sub-2179_ses-T2,302,720,0.4194,418,836,13.93333333,3.4,184
sub-2180_ses-T1,128,360,0.3556,232,464,7.733333333,3.4,185
sub-2180_ses-T2,28,360,0.0778,332,664,11.06666667,3.4,186
sub-2181_ses-T1,257,360,0.7139,103,206,3.433333333,3.4,187
sub-2182_ses-T1,29,51,0.5686,22,44,0.733333333,3.4,188
sub-2184_ses-T1,254,391,0.6496,137,274,4.566666667,3.4,189
sub-2185_ses-T1,186,360,0.5167,174,348,5.8,3.4,190
sub-2186_ses-T1,41,371,0.1105,330,660,11,3.4,191
sub-2187_ses-T1,36,48,0.75,12,24,0.4,3.4,192
sub-2188_ses-T1,330,445,0.7416,115,230,3.833333333,3.4,193
sub-2189_ses-T1,167,204,0.8186,37,74,1.233333333,3.4,194
sub-2190_ses-T1,165,360,0.4583,195,390,6.5,3.4,195
sub-2191_ses-T1,230,360,0.6389,130,260,4.333333333,3.4,196
sub-2191_ses-T2,0,360,0,360,720,12,3.4,197
sub-2192_ses-T1,227,360,0.6306,133,266,4.433333333,3.4,198
sub-2193_ses-T2,423,625,0.6768,202,404,6.733333333,3.4,199
sub-2194_ses-T1,225,415,0.5422,190,380,6.333333333,3.4,200
sub-2195_ses-T1,55,360,0.1528,305,610,10.16666667,3.4,201
sub-2196_ses-T1,104,416,0.25,312,624,10.4,3.4,202
sub-2197_ses-T1,292,439,0.6651,147,294,4.9,3.4,203
sub-2197_ses-T2,78,384,0.2031,306,612,10.2,3.4,204
sub-2198_ses-T1,240,407,0.5897,167,334,5.566666667,3.4,205
sub-2199_ses-T1,239,404,0.5916,165,330,5.5,3.4,206
sub-2200_ses-T1,111,360,0.3083,249,498,8.3,3.4,207
sub-2201_ses-T1,218,360,0.6056,142,284,4.733333333,3.4,208
sub-2202_ses-T1,130,606,0.2145,476,952,15.86666667,3.4,209
sub-2203_ses-T1,105,360,0.2917,255,510,8.5,3.4,210
sub-2204_ses-T1,210,360,0.5833,150,300,5,3.4,211
sub-2204_ses-T2,211,360,0.5861,149,298,4.966666667,3.4,212
sub-2205_ses-T1,147,360,0.4083,213,426,7.1,3.4,213
sub-2206_ses-T1,269,360,0.7472,91,182,3.033333333,3.4,214
sub-2206_ses-T2,228,720,0.3167,492,984,16.4,3.4,215
sub-2207_ses-T1,59,360,0.1639,301,602,10.03333333,3.4,216
sub-2207_ses-T2,64,360,0.1778,296,592,9.866666667,3.4,217
sub-2208_ses-T1,245,360,0.6806,115,230,3.833333333,3.4,218
sub-2208_ses-T2,130,360,0.3611,230,460,7.666666667,3.4,219
sub-2209_ses-T1,191,341,0.5601,150,300,5,3.4,220
sub-2210_ses-T1,25,38,0.6579,13,26,0.433333333,3.4,221
sub-2211_ses-T1,191,360,0.5306,169,338,5.633333333,3.4,222
sub-2212_ses-T1,240,360,0.6667,120,240,4,3.4,223
sub-2213_ses-T1,103,286,0.3601,183,366,6.1,3.4,224
sub-2214_ses-T1,304,373,0.815,69,138,2.3,3.4,225
sub-2215_ses-T1,228,360,0.6333,132,264,4.4,3.4,226
sub-2216_ses-T1,19,86,0.2209,67,134,2.233333333,3.4,227
sub-2216_ses-T2,61,181,0.337,120,240,4,3.4,228
sub-2217_ses-T1,66,360,0.1833,294,588,9.8,3.4,229
sub-2217_ses-T2,14,360,0.0389,346,692,11.53333333,3.4,230
sub-2218_ses-T1,133,360,0.3694,227,454,7.566666667,3.4,231
sub-2218_ses-T2,122,720,0.1694,598,1196,19.93333333,3.4,232
sub-2219_ses-T1,304,360,0.8444,56,112,1.866666667,3.4,233
sub-2220_ses-T1,267,360,0.7417,93,186,3.1,3.4,234
sub-2220_ses-T2,18,720,0.025,702,1404,23.4,3.4,235
sub-2221_ses-T1,61,360,0.1694,299,598,9.966666667,3.4,236
sub-2221_ses-T2,286,720,0.3972,434,868,14.46666667,3.4,237
sub-2222_ses-T1,118,360,0.3278,242,484,8.066666667,3.4,238
sub-2223_ses-T1,171,360,0.475,189,378,6.3,3.4,239
sub-2223_ses-T2,180,720,0.25,540,1080,18,3.4,240
sub-2224_ses-T1,142,379,0.3747,237,474,7.9,3.4,241
sub-2225_ses-T1,209,360,0.5806,151,302,5.033333333,3.4,242
sub-2225_ses-T2,193,759,0.2543,566,1132,18.86666667,3.4,243
sub-2226_ses-T1,85,365,0.2329,280,560,9.333333333,3.4,244
sub-2226_ses-T2,35,360,0.0972,325,650,10.83333333,3.4,245
sub-2227_ses-T1,183,360,0.5083,177,354,5.9,3.4,246
sub-2228_ses-T1,209,360,0.5806,151,302,5.033333333,3.4,247
sub-2228_ses-T2,227,729,0.3114,502,1004,16.73333333,3.4,248
sub-2229_ses-T1,294,360,0.8167,66,132,2.2,3.4,249
sub-2229_ses-T2,55,390,0.141,335,670,11.16666667,3.4,250
sub-2230_ses-T1,289,398,0.7261,109,218,3.633333333,3.4,251
sub-7001_ses-f2,166,720,0.2306,554,1108,18.46666667,3.4,252
sub-7001_ses-f3,42,720,0.0583,678,1356,22.6,3.4,253
sub-7002_ses-f1,146,720,0.2028,574,1148,19.13333333,3.4,254
sub-7002_ses-f2,250,720,0.3472,470,940,15.66666667,3.4,255
sub-7003_ses-f1,58,360,0.1611,302,604,10.06666667,3.4,256
sub-7003_ses-f2,4,180,0.0222,176,352,5.866666667,3.4,257
sub-7004_ses-f3,270,724,0.3729,454,908,15.13333333,3.4,258
sub-7006_ses-f1,31,52,0.5962,21,42,0.7,3.4,259
sub-7008_ses-f1,345,720,0.4792,375,750,12.5,3.4,260
sub-7008_ses-f2,73,720,0.1014,647,1294,21.56666667,3.4,261
sub-7009_ses-f1,282,720,0.3917,438,876,14.6,3.4,262
sub-7009_ses-f2,164,720,0.2278,556,1112,18.53333333,3.4,263
sub-7011_ses-f1,842,917,0.9182,75,150,2.5,3.4,264
sub-7011_ses-f2,92,360,0.2556,268,536,8.933333333,3.4,265
sub-7012_ses-f1,607,761,0.7976,154,308,5.133333333,3.4,266
sub-7012_ses-f2,311,720,0.4319,409,818,13.63333333,3.4,267
sub-7014_ses-f1,46,360,0.1278,314,628,10.46666667,3.4,268
sub-7014_ses-f2,261,720,0.3625,459,918,15.3,3.4,269
sub-7015_ses-f1,575,832,0.6911,257,514,8.566666667,3.4,270
sub-7015_ses-f2,234,729,0.321,495,990,16.5,3.4,271
sub-7016_ses-f1,342,750,0.456,408,816,13.6,3.4,272
sub-7016_ses-f2,69,720,0.0958,651,1302,21.7,3.4,273
sub-7017_ses-f1,629,740,0.85,111,222,3.7,3.4,274
sub-7017_ses-f2,431,725,0.5945,294,588,9.8,3.4,275
sub-7020_ses-f1,151,740,0.2041,589,1178,19.63333333,3.4,276
sub-7020_ses-f2,154,720,0.2139,566,1132,18.86666667,3.4,277
sub-7021_ses-f1,606,753,0.8048,147,294,4.9,3.4,278
sub-7022_ses-f1,547,720,0.7597,173,346,5.766666667,3.4,279
sub-7022_ses-f2,322,727,0.4429,405,810,13.5,3.4,280
sub-7023_ses-f1,357,744,0.4798,387,774,12.9,3.4,281
sub-7023_ses-f2,433,829,0.5223,396,792,13.2,3.4,282
sub-7024_ses-f1,500,728,0.6868,228,456,7.6,3.4,283
sub-7025_ses-f1,203,729,0.2785,526,1052,17.53333333,3.4,284
sub-7025_ses-f2,137,760,0.1803,623,1246,20.76666667,3.4,285
sub-7026_ses-f1,497,920,0.5402,423,846,14.1,3.4,286
sub-7026_ses-f2,501,914,0.5481,413,826,13.76666667,3.4,287
sub-7026_ses-f3,82,731,0.1122,649,1298,21.63333333,3.4,288
sub-7027_ses-f1,746,885,0.8429,139,278,4.633333333,3.4,289
sub-7027_ses-f2,84,410,0.2049,326,652,10.86666667,3.4,290
sub-7027_ses-f3,59,725,0.0814,666,1332,22.2,3.4,291
sub-7028_ses-f1,693,752,0.9215,59,118,1.966666667,3.4,292
sub-7028_ses-f2,476,720,0.6611,244,488,8.133333333,3.4,293
sub-7029_ses-f1,301,731,0.4118,430,860,14.33333333,3.4,294
sub-7029_ses-f2,216,725,0.2979,509,1018,16.96666667,3.4,295
sub-7030_ses-f1,414,720,0.575,306,612,10.2,3.4,296
sub-7030_ses-f2,207,794,0.2607,587,1174,19.56666667,3.4,297
sub-7031_ses-f1,9,192,0.0469,183,366,6.1,3.4,298
sub-7031_ses-f2,6,374,0.016,368,736,12.26666667,3.4,299
sub-7031_ses-f3,250,737,0.3392,487,974,16.23333333,3.4,300
sub-7032_ses-f1,683,720,0.9486,37,74,1.233333333,3.4,301
sub-7032_ses-f2,36,73,0.4932,37,74,1.233333333,3.4,302
sub-7032_ses-f3,399,740,0.5392,341,682,11.36666667,3.4,303
sub-7033_ses-f2,261,752,0.3471,491,982,16.36666667,3.4,304
sub-7034_ses-f1,555,760,0.7303,205,410,6.833333333,3.4,305
sub-7034_ses-f2,444,912,0.4868,468,936,15.6,3.4,306
sub-7034_ses-f3,90,728,0.1236,638,1276,21.26666667,3.4,307
sub-7035_ses-f1,11,50,0.22,39,78,1.3,3.4,308
sub-7035_ses-f2,94,727,0.1293,633,1266,21.1,3.4,309
sub-7036_ses-f1,201,745,0.2698,544,1088,18.13333333,3.4,310
sub-7037_ses-f1,722,772,0.9352,50,100,1.666666667,3.4,311
sub-7037_ses-f2,612,852,0.7183,240,480,8,3.4,312
sub-7037_ses-f3,137,720,0.1903,583,1166,19.43333333,3.4,313
sub-7038_ses-f1,421,789,0.5336,368,736,12.26666667,3.4,314
sub-7038_ses-f2,224,785,0.2854,561,1122,18.7,3.4,315
sub-7039_ses-f1,366,785,0.4662,419,838,13.96666667,3.4,316
sub-7039_ses-f2,185,727,0.2545,542,1084,18.06666667,3.4,317
sub-7040_ses-f1,300,728,0.4121,428,856,14.26666667,3.4,318
sub-7040_ses-f2,132,720,0.1833,588,1176,19.6,3.4,319
sub-7040_ses-f3,160,720,0.2222,560,1120,18.66666667,3.4,320
sub-7041_ses-f1,484,754,0.6419,270,540,9,3.4,321
sub-7041_ses-f2,173,735,0.2354,562,1124,18.73333333,3.4,322
sub-7042_ses-f3,215,658,0.3267,443,886,14.76666667,3.4,323
sub-7043_ses-f2,321,1080,0.2972,759,1518,25.3,3.4,324
sub-7044_ses-f2,327,739,0.4425,412,824,13.73333333,3.4,325
sub-7045_ses-f1,472,823,0.5735,351,702,11.7,3.4,326
sub-7046_ses-f1,370,812,0.4557,442,884,14.73333333,3.4,327
sub-7046_ses-f2,30,61,0.4918,31,62,1.033333333,3.4,328
sub-7046_ses-f3,82,741,0.1107,659,1318,21.96666667,3.4,329
sub-7047_ses-f1,361,720,0.5014,359,718,11.96666667,3.4,330
sub-7047_ses-f2,31,64,0.4844,33,66,1.1,3.4,331
sub-7048_ses-f1,4,6,0.6667,2,4,0.066666667,3.4,332
sub-7048_ses-f2,135,360,0.375,225,450,7.5,3.4,333
sub-7049_ses-f1,61,360,0.1694,299,598,9.966666667,3.4,334
sub-7052_ses-f1,83,518,0.1602,435,870,14.5,3.4,335
sub-7053_ses-f1,286,720,0.3972,434,868,14.46666667,3.4,336
sub-7054_ses-f1,457,766,0.5966,309,618,10.3,3.4,337
sub-2006_ses-T1,130,420,0.3095,290,580,9.666666667,3.6,1
sub-2011_ses-T1,104,360,0.2889,256,512,8.533333333,3.6,2
sub-2012_ses-T1,179,180,0.9944,1,2,0.033333333,3.6,3
sub-2013_ses-T1,141,360,0.3917,219,438,7.3,3.6,4
sub-2014_ses-T1,137,360,0.3806,223,446,7.433333333,3.6,5
sub-2015_ses-T1,9,180,0.05,171,342,5.7,3.6,6
sub-2016_ses-T1,123,360,0.3417,237,474,7.9,3.6,7
sub-2017_ses-T1,125,180,0.6944,55,110,1.833333333,3.6,8
sub-2018_ses-T1,35,180,0.1944,145,290,4.833333333,3.6,9
sub-2019_ses-T1,202,360,0.5611,158,316,5.266666667,3.6,10
sub-2020_ses-T1,16,26,0.6154,10,20,0.333333333,3.6,11
sub-2020_ses-T2,93,360,0.2583,267,534,8.9,3.6,12
sub-2021_ses-T1,101,360,0.2806,259,518,8.633333333,3.6,13
sub-2022_ses-T1,159,360,0.4417,201,402,6.7,3.6,14
sub-2023_ses-T1,77,360,0.2139,283,566,9.433333333,3.6,15
sub-2024_ses-T2,3,12,0.25,9,18,0.3,3.6,16
sub-2026_ses-T1,81,223,0.3632,142,284,4.733333333,3.6,17
sub-2027_ses-T1,243,360,0.675,117,234,3.9,3.6,18
sub-2028_ses-T1,88,360,0.2444,272,544,9.066666667,3.6,19
sub-2029_ses-T1,125,360,0.3472,235,470,7.833333333,3.6,20
sub-2030_ses-T1,64,360,0.1778,296,592,9.866666667,3.6,21
sub-2031_ses-T1,323,360,0.8972,37,74,1.233333333,3.6,22
sub-2032_ses-T1,59,360,0.1639,301,602,10.03333333,3.6,23
sub-2033_ses-T1,251,360,0.6972,109,218,3.633333333,3.6,24
sub-2033_ses-T2,84,360,0.2333,276,552,9.2,3.6,25
sub-2034_ses-T1,5,180,0.0278,175,350,5.833333333,3.6,26
sub-2035_ses-T1,267,360,0.7417,93,186,3.1,3.6,27
sub-2036_ses-T1,189,360,0.525,171,342,5.7,3.6,28
sub-2037_ses-T1,150,360,0.4167,210,420,7,3.6,29
sub-2038_ses-T1,286,360,0.7944,74,148,2.466666667,3.6,30
sub-2039_ses-T1,174,180,0.9667,6,12,0.2,3.6,31
sub-2040_ses-T1,212,360,0.5889,148,296,4.933333333,3.6,32
sub-2041_ses-T1,194,360,0.5389,166,332,5.533333333,3.6,33
sub-2042_ses-T1,22,180,0.1222,158,316,5.266666667,3.6,34
sub-2043_ses-T1,57,360,0.1583,303,606,10.1,3.6,35
sub-2044_ses-T1,78,360,0.2167,282,564,9.4,3.6,36
sub-2045_ses-T1,8,180,0.0444,172,344,5.733333333,3.6,37
sub-2046_ses-T1,90,180,0.5,90,180,3,3.6,38
sub-2047_ses-T1,29,180,0.1611,151,302,5.033333333,3.6,39
sub-2048_ses-T1,111,180,0.6167,69,138,2.3,3.6,40
sub-2049_ses-T1,190,360,0.5278,170,340,5.666666667,3.6,41
sub-2051_ses-T1,283,360,0.7861,77,154,2.566666667,3.6,42
sub-2051_ses-T2,304,360,0.8444,56,112,1.866666667,3.6,43
sub-2052_ses-T1,139,360,0.3861,221,442,7.366666667,3.6,44
sub-2052_ses-T2,31,180,0.1722,149,298,4.966666667,3.6,45
sub-2053_ses-T1,102,360,0.2833,258,516,8.6,3.6,46
sub-2055_ses-T1,35,180,0.1944,145,290,4.833333333,3.6,47
sub-2056_ses-T1,340,360,0.9444,20,40,0.666666667,3.6,48
sub-2057_ses-T1,161,360,0.4472,199,398,6.633333333,3.6,49
sub-2058_ses-T1,164,360,0.4556,196,392,6.533333333,3.6,50
sub-2059_ses-T1,172,360,0.4778,188,376,6.266666667,3.6,51
sub-2061_ses-T1,25,180,0.1389,155,310,5.166666667,3.6,52
sub-2062_ses-T1,267,360,0.7417,93,186,3.1,3.6,53
sub-2063_ses-T1,94,360,0.2611,266,532,8.866666667,3.6,54
sub-2064_ses-T1,74,180,0.4111,106,212,3.533333333,3.6,55
sub-2065_ses-T1,1,180,0.0056,179,358,5.966666667,3.6,56
sub-2066_ses-T1,86,180,0.4778,94,188,3.133333333,3.6,57
sub-2066_ses-T2,148,360,0.4111,212,424,7.066666667,3.6,58
sub-2067_ses-T1,130,360,0.3611,230,460,7.666666667,3.6,59
sub-2068_ses-T1,195,360,0.5417,165,330,5.5,3.6,60
sub-2069_ses-T1,57,360,0.1583,303,606,10.1,3.6,61
sub-2070_ses-T1,158,360,0.4389,202,404,6.733333333,3.6,62
sub-2071_ses-T1,191,360,0.5306,169,338,5.633333333,3.6,63
sub-2072_ses-T1,221,360,0.6139,139,278,4.633333333,3.6,64
sub-2073_ses-T1,221,256,0.8633,35,70,1.166666667,3.6,65
sub-2073_ses-T2,49,180,0.2722,131,262,4.366666667,3.6,66
sub-2074_ses-T1,12,180,0.0667,168,336,5.6,3.6,67
sub-2075_ses-T1,87,180,0.4833,93,186,3.1,3.6,68
sub-2076_ses-T1,99,360,0.275,261,522,8.7,3.6,69
sub-2076_ses-T2,40,360,0.1111,320,640,10.66666667,3.6,70
sub-2077_ses-T1,223,360,0.6194,137,274,4.566666667,3.6,71
sub-2078_ses-T1,173,360,0.4806,187,374,6.233333333,3.6,72
sub-2079_ses-T1,173,360,0.4806,187,374,6.233333333,3.6,73
sub-2079_ses-T2,61,360,0.1694,299,598,9.966666667,3.6,74
sub-2080_ses-T1,81,360,0.225,279,558,9.3,3.6,75
sub-2081_ses-T1,179,360,0.4972,181,362,6.033333333,3.6,76
sub-2082_ses-T1,99,360,0.275,261,522,8.7,3.6,77
sub-2083_ses-T1,83,360,0.2306,277,554,9.233333333,3.6,78
sub-2084_ses-T1,305,360,0.8472,55,110,1.833333333,3.6,79
sub-2085_ses-T1,131,360,0.3639,229,458,7.633333333,3.6,80
sub-2086_ses-T1,20,360,0.0556,340,680,11.33333333,3.6,81
sub-2087_ses-T1,316,360,0.8778,44,88,1.466666667,3.6,82
sub-2088_ses-T1,162,360,0.45,198,396,6.6,3.6,83
sub-2089_ses-T1,137,180,0.7611,43,86,1.433333333,3.6,84
sub-2091_ses-T1,56,360,0.1556,304,608,10.13333333,3.6,85
sub-2092_ses-T1,182,360,0.5056,178,356,5.933333333,3.6,86
sub-2093_ses-T1,174,360,0.4833,186,372,6.2,3.6,87
sub-2094_ses-T1,162,180,0.9,18,36,0.6,3.6,88
sub-2095_ses-T1,156,360,0.4333,204,408,6.8,3.6,89
sub-2096_ses-T1,155,360,0.4306,205,410,6.833333333,3.6,90
sub-2097_ses-T1,315,540,0.5833,225,450,7.5,3.6,91
sub-2098_ses-T1,55,360,0.1528,305,610,10.16666667,3.6,92
sub-2099_ses-T1,41,180,0.2278,139,278,4.633333333,3.6,93
sub-2099_ses-T2,74,360,0.2056,286,572,9.533333333,3.6,94
sub-2100_ses-T1,93,180,0.5167,87,174,2.9,3.6,95
sub-2100_ses-T2,75,360,0.2083,285,570,9.5,3.6,96
sub-2101_ses-T1,155,360,0.4306,205,410,6.833333333,3.6,97
sub-2101_ses-T2,118,360,0.3278,242,484,8.066666667,3.6,98
sub-2102_ses-T1,169,360,0.4694,191,382,6.366666667,3.6,99
sub-2103_ses-T1,131,360,0.3639,229,458,7.633333333,3.6,100
sub-2103_ses-T2,209,360,0.5806,151,302,5.033333333,3.6,101
sub-2104_ses-T1,257,387,0.6641,130,260,4.333333333,3.6,102
sub-2105_ses-T1,216,360,0.6,144,288,4.8,3.6,103
sub-2105_ses-T2,217,360,0.6028,143,286,4.766666667,3.6,104
sub-2106_ses-T1,250,360,0.6944,110,220,3.666666667,3.6,105
sub-2107_ses-T1,86,360,0.2389,274,548,9.133333333,3.6,106
sub-2107_ses-T2,116,360,0.3222,244,488,8.133333333,3.6,107
sub-2108_ses-T1,301,360,0.8361,59,118,1.966666667,3.6,108
sub-2108_ses-T3,86,141,0.6099,55,110,1.833333333,3.6,109
sub-2109_ses-T1,54,180,0.3,126,252,4.2,3.6,110
sub-2110_ses-T1,195,274,0.7117,79,158,2.633333333,3.6,111
sub-2115_ses-T1,203,360,0.5639,157,314,5.233333333,3.6,112
sub-2115_ses-T2,111,360,0.3083,249,498,8.3,3.6,113
sub-2117_ses-T1,154,360,0.4278,206,412,6.866666667,3.6,114
sub-2117_ses-T2,51,360,0.1417,309,618,10.3,3.6,115
sub-2118_ses-T1,114,360,0.3167,246,492,8.2,3.6,116
sub-2120_ses-T1,161,360,0.4472,199,398,6.633333333,3.6,117
sub-2122_ses-T1,181,360,0.5028,179,358,5.966666667,3.6,118
sub-2123_ses-T1,290,360,0.8056,70,140,2.333333333,3.6,119
sub-2124_ses-T1,332,404,0.8218,72,144,2.4,3.6,120
sub-2126_ses-T1,188,360,0.5222,172,344,5.733333333,3.6,121
sub-2128_ses-T1,202,360,0.5611,158,316,5.266666667,3.6,122
sub-2133_ses-T1,137,360,0.3806,223,446,7.433333333,3.6,123
sub-2135_ses-T1,7,19,0.3684,12,24,0.4,3.6,124
sub-2136_ses-T1,288,720,0.4,432,864,14.4,3.6,125
sub-2137_ses-T1,184,720,0.2556,536,1072,17.86666667,3.6,126
sub-2137_ses-T2,102,360,0.2833,258,516,8.6,3.6,127
sub-2138_ses-T1,244,360,0.6778,116,232,3.866666667,3.6,128
sub-2139_ses-T1,71,360,0.1972,289,578,9.633333333,3.6,129
sub-2140_ses-T1,376,379,0.9921,3,6,0.1,3.6,130
sub-2141_ses-T1,125,360,0.3472,235,470,7.833333333,3.6,131
sub-2142_ses-T2,275,360,0.7639,85,170,2.833333333,3.6,132
sub-2143_ses-T1,162,360,0.45,198,396,6.6,3.6,133
sub-2144_ses-T1,174,372,0.4677,198,396,6.6,3.6,134
sub-2145_ses-T1,172,360,0.4778,188,376,6.266666667,3.6,135
sub-2145_ses-T2,47,360,0.1306,313,626,10.43333333,3.6,136
sub-2146_ses-T1,257,360,0.7139,103,206,3.433333333,3.6,137
sub-2146_ses-T2,244,720,0.3389,476,952,15.86666667,3.6,138
sub-2147_ses-T1,91,360,0.2528,269,538,8.966666667,3.6,139
sub-2147_ses-T2,115,360,0.3194,245,490,8.166666667,3.6,140
sub-2148_ses-T1,315,399,0.7895,84,168,2.8,3.6,141
sub-2149_ses-T1,172,360,0.4778,188,376,6.266666667,3.6,142
sub-2150_ses-T1,276,360,0.7667,84,168,2.8,3.6,143
sub-2150_ses-T2,156,360,0.4333,204,408,6.8,3.6,144
sub-2151_ses-T1,224,720,0.3111,496,992,16.53333333,3.6,145
sub-2151_ses-T2,381,773,0.4929,392,784,13.06666667,3.6,146
sub-2152_ses-T1,297,360,0.825,63,126,2.1,3.6,147
sub-2152_ses-T2,127,360,0.3528,233,466,7.766666667,3.6,148
sub-2153_ses-T1,275,383,0.718,108,216,3.6,3.6,149
sub-2154_ses-T2,246,360,0.6833,114,228,3.8,3.6,150
sub-2155_ses-T1,128,360,0.3556,232,464,7.733333333,3.6,151
sub-2156_ses-T1,96,360,0.2667,264,528,8.8,3.6,152
sub-2157_ses-T1,213,360,0.5917,147,294,4.9,3.6,153
sub-2158_ses-T1,189,360,0.525,171,342,5.7,3.6,154
sub-2159_ses-T1,113,360,0.3139,247,494,8.233333333,3.6,155
sub-2160_ses-T1,63,360,0.175,297,594,9.9,3.6,156
sub-2161_ses-T1,187,360,0.5194,173,346,5.766666667,3.6,157
sub-2162_ses-T1,216,360,0.6,144,288,4.8,3.6,158
sub-2163_ses-T1,272,399,0.6817,127,254,4.233333333,3.6,159
sub-2164_ses-T1,134,720,0.1861,586,1172,19.53333333,3.6,160
sub-2164_ses-T2,285,720,0.3958,435,870,14.5,3.6,161
sub-2165_ses-T1,171,481,0.3555,310,620,10.33333333,3.6,162
sub-2166_ses-T1,201,360,0.5583,159,318,5.3,3.6,163
sub-2166_ses-T2,167,360,0.4639,193,386,6.433333333,3.6,164
sub-2167_ses-T1,251,370,0.6784,119,238,3.966666667,3.6,165
sub-2168_ses-T1,237,360,0.6583,123,246,4.1,3.6,166
sub-2168_ses-T2,169,360,0.4694,191,382,6.366666667,3.6,167
sub-2169_ses-T1,199,360,0.5528,161,322,5.366666667,3.6,168
sub-2169_ses-T2,131,360,0.3639,229,458,7.633333333,3.6,169
sub-2170_ses-T1,99,264,0.375,165,330,5.5,3.6,170
sub-2171_ses-T1,269,374,0.7193,105,210,3.5,3.6,171
sub-2171_ses-T2,175,483,0.3623,308,616,10.26666667,3.6,172
sub-2171_ses-T3,115,577,0.1993,462,924,15.4,3.6,173
sub-2172_ses-T1,157,513,0.306,356,712,11.86666667,3.6,174
sub-2172_ses-T2,258,386,0.6684,128,256,4.266666667,3.6,175
sub-2173_ses-T1,87,360,0.2417,273,546,9.1,3.6,176
sub-2174_ses-T1,169,416,0.4062,247,494,8.233333333,3.6,177
sub-2175_ses-T1,447,679,0.6583,232,464,7.733333333,3.6,178
sub-2176_ses-T1,99,360,0.275,261,522,8.7,3.6,179
sub-2176_ses-T2,0,360,0,360,720,12,3.6,180
sub-2177_ses-T1,608,695,0.8748,87,174,2.9,3.6,181
sub-2177_ses-T2,257,736,0.3492,479,958,15.96666667,3.6,182
sub-2178_ses-T2,88,360,0.2444,272,544,9.066666667,3.6,183
sub-2179_ses-T2,284,720,0.3944,436,872,14.53333333,3.6,184
sub-2180_ses-T1,124,360,0.3444,236,472,7.866666667,3.6,185
sub-2180_ses-T2,25,360,0.0694,335,670,11.16666667,3.6,186
sub-2181_ses-T1,250,360,0.6944,110,220,3.666666667,3.6,187
sub-2182_ses-T1,29,51,0.5686,22,44,0.733333333,3.6,188
sub-2184_ses-T1,250,391,0.6394,141,282,4.7,3.6,189
sub-2185_ses-T1,169,360,0.4694,191,382,6.366666667,3.6,190
sub-2186_ses-T1,32,371,0.0863,339,678,11.3,3.6,191
sub-2187_ses-T1,33,48,0.6875,15,30,0.5,3.6,192
sub-2188_ses-T1,318,445,0.7146,127,254,4.233333333,3.6,193
sub-2189_ses-T1,166,204,0.8137,38,76,1.266666667,3.6,194
sub-2190_ses-T1,160,360,0.4444,200,400,6.666666667,3.6,195
sub-2191_ses-T1,213,360,0.5917,147,294,4.9,3.6,196
sub-2191_ses-T2,0,360,0,360,720,12,3.6,197
sub-2192_ses-T1,211,360,0.5861,149,298,4.966666667,3.6,198
sub-2193_ses-T2,410,625,0.656,215,430,7.166666667,3.6,199
sub-2194_ses-T1,208,415,0.5012,207,414,6.9,3.6,200
sub-2195_ses-T1,51,360,0.1417,309,618,10.3,3.6,201
sub-2196_ses-T1,98,416,0.2356,318,636,10.6,3.6,202
sub-2197_ses-T1,282,439,0.6424,157,314,5.233333333,3.6,203
sub-2197_ses-T2,70,384,0.1823,314,628,10.46666667,3.6,204
sub-2198_ses-T1,228,407,0.5602,179,358,5.966666667,3.6,205
sub-2199_ses-T1,230,404,0.5693,174,348,5.8,3.6,206
sub-2200_ses-T1,106,360,0.2944,254,508,8.466666667,3.6,207
sub-2201_ses-T1,197,360,0.5472,163,326,5.433333333,3.6,208
sub-2202_ses-T1,118,606,0.1947,488,976,16.26666667,3.6,209
sub-2203_ses-T1,91,360,0.2528,269,538,8.966666667,3.6,210
sub-2204_ses-T1,199,360,0.5528,161,322,5.366666667,3.6,211
sub-2204_ses-T2,200,360,0.5556,160,320,5.333333333,3.6,212
sub-2205_ses-T1,135,360,0.375,225,450,7.5,3.6,213
sub-2206_ses-T1,259,360,0.7194,101,202,3.366666667,3.6,214
sub-2206_ses-T2,224,720,0.3111,496,992,16.53333333,3.6,215
sub-2207_ses-T1,56,360,0.1556,304,608,10.13333333,3.6,216
sub-2207_ses-T2,54,360,0.15,306,612,10.2,3.6,217
sub-2208_ses-T1,241,360,0.6694,119,238,3.966666667,3.6,218
sub-2208_ses-T2,120,360,0.3333,240,480,8,3.6,219
sub-2209_ses-T1,187,341,0.5484,154,308,5.133333333,3.6,220
sub-2210_ses-T1,25,38,0.6579,13,26,0.433333333,3.6,221
sub-2211_ses-T1,171,360,0.475,189,378,6.3,3.6,222
sub-2212_ses-T1,230,360,0.6389,130,260,4.333333333,3.6,223
sub-2213_ses-T1,92,286,0.3217,194,388,6.466666667,3.6,224
sub-2214_ses-T1,301,373,0.807,72,144,2.4,3.6,225
sub-2215_ses-T1,208,360,0.5778,152,304,5.066666667,3.6,226
sub-2216_ses-T1,17,86,0.1977,69,138,2.3,3.6,227
sub-2216_ses-T2,59,181,0.326,122,244,4.066666667,3.6,228
sub-2217_ses-T1,57,360,0.1583,303,606,10.1,3.6,229
sub-2217_ses-T2,14,360,0.0389,346,692,11.53333333,3.6,230
sub-2218_ses-T1,123,360,0.3417,237,474,7.9,3.6,231
sub-2218_ses-T2,114,720,0.1583,606,1212,20.2,3.6,232
sub-2219_ses-T1,295,360,0.8194,65,130,2.166666667,3.6,233
sub-2220_ses-T1,256,360,0.7111,104,208,3.466666667,3.6,234
sub-2220_ses-T2,16,720,0.0222,704,1408,23.46666667,3.6,235
sub-2221_ses-T1,60,360,0.1667,300,600,10,3.6,236
sub-2221_ses-T2,278,720,0.3861,442,884,14.73333333,3.6,237
sub-2222_ses-T1,111,360,0.3083,249,498,8.3,3.6,238
sub-2223_ses-T1,159,360,0.4417,201,402,6.7,3.6,239
sub-2223_ses-T2,154,720,0.2139,566,1132,18.86666667,3.6,240
sub-2224_ses-T1,132,379,0.3483,247,494,8.233333333,3.6,241
sub-2225_ses-T1,196,360,0.5444,164,328,5.466666667,3.6,242
sub-2225_ses-T2,178,759,0.2345,581,1162,19.36666667,3.6,243
sub-2226_ses-T1,79,365,0.2164,286,572,9.533333333,3.6,244
sub-2226_ses-T2,29,360,0.0806,331,662,11.03333333,3.6,245
sub-2227_ses-T1,169,360,0.4694,191,382,6.366666667,3.6,246
sub-2228_ses-T1,194,360,0.5389,166,332,5.533333333,3.6,247
sub-2228_ses-T2,212,729,0.2908,517,1034,17.23333333,3.6,248
sub-2229_ses-T1,286,360,0.7944,74,148,2.466666667,3.6,249
sub-2229_ses-T2,51,390,0.1308,339,678,11.3,3.6,250
sub-2230_ses-T1,273,398,0.6859,125,250,4.166666667,3.6,251
sub-7001_ses-f2,159,720,0.2208,561,1122,18.7,3.6,252
sub-7001_ses-f3,39,720,0.0542,681,1362,22.7,3.6,253
sub-7002_ses-f1,125,720,0.1736,595,1190,19.83333333,3.6,254
sub-7002_ses-f2,236,720,0.3278,484,968,16.13333333,3.6,255
sub-7003_ses-f1,54,360,0.15,306,612,10.2,3.6,256
sub-7003_ses-f2,3,180,0.0167,177,354,5.9,3.6,257
sub-7004_ses-f3,262,724,0.3619,462,924,15.4,3.6,258
sub-7006_ses-f1,27,52,0.5192,25,50,0.833333333,3.6,259
sub-7008_ses-f1,329,720,0.4569,391,782,13.03333333,3.6,260
sub-7008_ses-f2,68,720,0.0944,652,1304,21.73333333,3.6,261
sub-7009_ses-f1,277,720,0.3847,443,886,14.76666667,3.6,262
sub-7009_ses-f2,159,720,0.2208,561,1122,18.7,3.6,263
sub-7011_ses-f1,823,917,0.8975,94,188,3.133333333,3.6,264
sub-7011_ses-f2,86,360,0.2389,274,548,9.133333333,3.6,265
sub-7012_ses-f1,600,761,0.7884,161,322,5.366666667,3.6,266
sub-7012_ses-f2,287,720,0.3986,433,866,14.43333333,3.6,267
sub-7014_ses-f1,39,360,0.1083,321,642,10.7,3.6,268
sub-7014_ses-f2,252,720,0.35,468,936,15.6,3.6,269
sub-7015_ses-f1,561,832,0.6743,271,542,9.033333333,3.6,270
sub-7015_ses-f2,220,729,0.3018,509,1018,16.96666667,3.6,271
sub-7016_ses-f1,317,750,0.4227,433,866,14.43333333,3.6,272
sub-7016_ses-f2,64,720,0.0889,656,1312,21.86666667,3.6,273
sub-7017_ses-f1,616,740,0.8324,124,248,4.133333333,3.6,274
sub-7017_ses-f2,399,725,0.5503,326,652,10.86666667,3.6,275
sub-7020_ses-f1,141,740,0.1905,599,1198,19.96666667,3.6,276
sub-7020_ses-f2,147,720,0.2042,573,1146,19.1,3.6,277
sub-7021_ses-f1,584,753,0.7756,169,338,5.633333333,3.6,278
sub-7022_ses-f1,526,720,0.7306,194,388,6.466666667,3.6,279
sub-7022_ses-f2,280,727,0.3851,447,894,14.9,3.6,280
sub-7023_ses-f1,342,744,0.4597,402,804,13.4,3.6,281
sub-7023_ses-f2,422,829,0.509,407,814,13.56666667,3.6,282
sub-7024_ses-f1,489,728,0.6717,239,478,7.966666667,3.6,283
sub-7025_ses-f1,180,729,0.2469,549,1098,18.3,3.6,284
sub-7025_ses-f2,131,760,0.1724,629,1258,20.96666667,3.6,285
sub-7026_ses-f1,479,920,0.5207,441,882,14.7,3.6,286
sub-7026_ses-f2,479,914,0.5241,435,870,14.5,3.6,287
sub-7026_ses-f3,80,731,0.1094,651,1302,21.7,3.6,288
sub-7027_ses-f1,723,885,0.8169,162,324,5.4,3.6,289
sub-7027_ses-f2,81,410,0.1976,329,658,10.96666667,3.6,290
sub-7027_ses-f3,52,725,0.0717,673,1346,22.43333333,3.6,291
sub-7028_ses-f1,681,752,0.9056,71,142,2.366666667,3.6,292
sub-7028_ses-f2,449,720,0.6236,271,542,9.033333333,3.6,293
sub-7029_ses-f1,284,731,0.3885,447,894,14.9,3.6,294
sub-7029_ses-f2,204,725,0.2814,521,1042,17.36666667,3.6,295
sub-7030_ses-f1,396,720,0.55,324,648,10.8,3.6,296
sub-7030_ses-f2,196,794,0.2469,598,1196,19.93333333,3.6,297
sub-7031_ses-f1,9,192,0.0469,183,366,6.1,3.6,298
sub-7031_ses-f2,6,374,0.016,368,736,12.26666667,3.6,299
sub-7031_ses-f3,225,737,0.3053,512,1024,17.06666667,3.6,300
sub-7032_ses-f1,680,720,0.9444,40,80,1.333333333,3.6,301
sub-7032_ses-f2,35,73,0.4795,38,76,1.266666667,3.6,302
sub-7032_ses-f3,381,740,0.5149,359,718,11.96666667,3.6,303
sub-7033_ses-f2,253,752,0.3364,499,998,16.63333333,3.6,304
sub-7034_ses-f1,539,760,0.7092,221,442,7.366666667,3.6,305
sub-7034_ses-f2,433,912,0.4748,479,958,15.96666667,3.6,306
sub-7034_ses-f3,85,728,0.1168,643,1286,21.43333333,3.6,307
sub-7035_ses-f1,10,50,0.2,40,80,1.333333333,3.6,308
sub-7035_ses-f2,89,727,0.1224,638,1276,21.26666667,3.6,309
sub-7036_ses-f1,193,745,0.2591,552,1104,18.4,3.6,310
sub-7037_ses-f1,717,772,0.9288,55,110,1.833333333,3.6,311
sub-7037_ses-f2,589,852,0.6913,263,526,8.766666667,3.6,312
sub-7037_ses-f3,127,720,0.1764,593,1186,19.76666667,3.6,313
sub-7038_ses-f1,411,789,0.5209,378,756,12.6,3.6,314
sub-7038_ses-f2,218,785,0.2777,567,1134,18.9,3.6,315
sub-7039_ses-f1,355,785,0.4522,430,860,14.33333333,3.6,316
sub-7039_ses-f2,174,727,0.2393,553,1106,18.43333333,3.6,317
sub-7040_ses-f1,297,728,0.408,431,862,14.36666667,3.6,318
sub-7040_ses-f2,123,720,0.1708,597,1194,19.9,3.6,319
sub-7040_ses-f3,151,720,0.2097,569,1138,18.96666667,3.6,320
sub-7041_ses-f1,457,754,0.6061,297,594,9.9,3.6,321
sub-7041_ses-f2,169,735,0.2299,566,1132,18.86666667,3.6,322
sub-7042_ses-f3,201,658,0.3055,457,914,15.23333333,3.6,323
sub-7043_ses-f2,309,1080,0.2861,771,1542,25.7,3.6,324
sub-7044_ses-f2,311,739,0.4208,428,856,14.26666667,3.6,325
sub-7045_ses-f1,445,823,0.5407,378,756,12.6,3.6,326
sub-7046_ses-f1,342,812,0.4212,470,940,15.66666667,3.6,327
sub-7046_ses-f2,30,61,0.4918,31,62,1.033333333,3.6,328
sub-7046_ses-f3,75,741,0.1012,666,1332,22.2,3.6,329
sub-7047_ses-f1,324,720,0.45,396,792,13.2,3.6,330
sub-7047_ses-f2,31,64,0.4844,33,66,1.1,3.6,331
sub-7048_ses-f1,4,6,0.6667,2,4,0.066666667,3.6,332
sub-7048_ses-f2,130,360,0.3611,230,460,7.666666667,3.6,333
sub-7049_ses-f1,61,360,0.1694,299,598,9.966666667,3.6,334
sub-7052_ses-f1,79,518,0.1525,439,878,14.63333333,3.6,335
sub-7053_ses-f1,263,720,0.3653,457,914,15.23333333,3.6,336
sub-7054_ses-f1,450,766,0.5875,316,632,10.53333333,3.6,337
sub-2006_ses-T1,124,420,0.2952,296,592,9.866666667,3.8,1
sub-2011_ses-T1,103,360,0.2861,257,514,8.566666667,3.8,2
sub-2012_ses-T1,179,180,0.9944,1,2,0.033333333,3.8,3
sub-2013_ses-T1,132,360,0.3667,228,456,7.6,3.8,4
sub-2014_ses-T1,127,360,0.3528,233,466,7.766666667,3.8,5
sub-2015_ses-T1,6,180,0.0333,174,348,5.8,3.8,6
sub-2016_ses-T1,115,360,0.3194,245,490,8.166666667,3.8,7
sub-2017_ses-T1,120,180,0.6667,60,120,2,3.8,8
sub-2018_ses-T1,32,180,0.1778,148,296,4.933333333,3.8,9
sub-2019_ses-T1,191,360,0.5306,169,338,5.633333333,3.8,10
sub-2020_ses-T1,16,26,0.6154,10,20,0.333333333,3.8,11
sub-2020_ses-T2,86,360,0.2389,274,548,9.133333333,3.8,12
sub-2021_ses-T1,95,360,0.2639,265,530,8.833333333,3.8,13
sub-2022_ses-T1,155,360,0.4306,205,410,6.833333333,3.8,14
sub-2023_ses-T1,75,360,0.2083,285,570,9.5,3.8,15
sub-2024_ses-T2,2,12,0.1667,10,20,0.333333333,3.8,16
sub-2026_ses-T1,78,223,0.3498,145,290,4.833333333,3.8,17
sub-2027_ses-T1,235,360,0.6528,125,250,4.166666667,3.8,18
sub-2028_ses-T1,81,360,0.225,279,558,9.3,3.8,19
sub-2029_ses-T1,114,360,0.3167,246,492,8.2,3.8,20
sub-2030_ses-T1,62,360,0.1722,298,596,9.933333333,3.8,21
sub-2031_ses-T1,316,360,0.8778,44,88,1.466666667,3.8,22
sub-2032_ses-T1,53,360,0.1472,307,614,10.23333333,3.8,23
sub-2033_ses-T1,245,360,0.6806,115,230,3.833333333,3.8,24
sub-2033_ses-T2,82,360,0.2278,278,556,9.266666667,3.8,25
sub-2034_ses-T1,5,180,0.0278,175,350,5.833333333,3.8,26
sub-2035_ses-T1,259,360,0.7194,101,202,3.366666667,3.8,27
sub-2036_ses-T1,177,360,0.4917,183,366,6.1,3.8,28
sub-2037_ses-T1,140,360,0.3889,220,440,7.333333333,3.8,29
sub-2038_ses-T1,273,360,0.7583,87,174,2.9,3.8,30
sub-2039_ses-T1,171,180,0.95,9,18,0.3,3.8,31
sub-2040_ses-T1,196,360,0.5444,164,328,5.466666667,3.8,32
sub-2041_ses-T1,181,360,0.5028,179,358,5.966666667,3.8,33
sub-2042_ses-T1,17,180,0.0944,163,326,5.433333333,3.8,34
sub-2043_ses-T1,55,360,0.1528,305,610,10.16666667,3.8,35
sub-2044_ses-T1,74,360,0.2056,286,572,9.533333333,3.8,36
sub-2045_ses-T1,8,180,0.0444,172,344,5.733333333,3.8,37
sub-2046_ses-T1,80,180,0.4444,100,200,3.333333333,3.8,38
sub-2047_ses-T1,25,180,0.1389,155,310,5.166666667,3.8,39
sub-2048_ses-T1,105,180,0.5833,75,150,2.5,3.8,40
sub-2049_ses-T1,182,360,0.5056,178,356,5.933333333,3.8,41
sub-2051_ses-T1,275,360,0.7639,85,170,2.833333333,3.8,42
sub-2051_ses-T2,300,360,0.8333,60,120,2,3.8,43
sub-2052_ses-T1,129,360,0.3583,231,462,7.7,3.8,44
sub-2052_ses-T2,31,180,0.1722,149,298,4.966666667,3.8,45
sub-2053_ses-T1,98,360,0.2722,262,524,8.733333333,3.8,46
sub-2055_ses-T1,34,180,0.1889,146,292,4.866666667,3.8,47
sub-2056_ses-T1,336,360,0.9333,24,48,0.8,3.8,48
sub-2057_ses-T1,150,360,0.4167,210,420,7,3.8,49
sub-2058_ses-T1,157,360,0.4361,203,406,6.766666667,3.8,50
sub-2059_ses-T1,168,360,0.4667,192,384,6.4,3.8,51
sub-2061_ses-T1,22,180,0.1222,158,316,5.266666667,3.8,52
sub-2062_ses-T1,259,360,0.7194,101,202,3.366666667,3.8,53
sub-2063_ses-T1,88,360,0.2444,272,544,9.066666667,3.8,54
sub-2064_ses-T1,68,180,0.3778,112,224,3.733333333,3.8,55
sub-2065_ses-T1,0,180,0,180,360,6,3.8,56
sub-2066_ses-T1,82,180,0.4556,98,196,3.266666667,3.8,57
sub-2066_ses-T2,137,360,0.3806,223,446,7.433333333,3.8,58
sub-2067_ses-T1,120,360,0.3333,240,480,8,3.8,59
sub-2068_ses-T1,183,360,0.5083,177,354,5.9,3.8,60
sub-2069_ses-T1,54,360,0.15,306,612,10.2,3.8,61
sub-2070_ses-T1,150,360,0.4167,210,420,7,3.8,62
sub-2071_ses-T1,182,360,0.5056,178,356,5.933333333,3.8,63
sub-2072_ses-T1,210,360,0.5833,150,300,5,3.8,64
sub-2073_ses-T1,219,256,0.8555,37,74,1.233333333,3.8,65
sub-2073_ses-T2,49,180,0.2722,131,262,4.366666667,3.8,66
sub-2074_ses-T1,12,180,0.0667,168,336,5.6,3.8,67
sub-2075_ses-T1,78,180,0.4333,102,204,3.4,3.8,68
sub-2076_ses-T1,92,360,0.2556,268,536,8.933333333,3.8,69
sub-2076_ses-T2,37,360,0.1028,323,646,10.76666667,3.8,70
sub-2077_ses-T1,202,360,0.5611,158,316,5.266666667,3.8,71
sub-2078_ses-T1,158,360,0.4389,202,404,6.733333333,3.8,72
sub-2079_ses-T1,165,360,0.4583,195,390,6.5,3.8,73
sub-2079_ses-T2,56,360,0.1556,304,608,10.13333333,3.8,74
sub-2080_ses-T1,75,360,0.2083,285,570,9.5,3.8,75
sub-2081_ses-T1,166,360,0.4611,194,388,6.466666667,3.8,76
sub-2082_ses-T1,96,360,0.2667,264,528,8.8,3.8,77
sub-2083_ses-T1,81,360,0.225,279,558,9.3,3.8,78
sub-2084_ses-T1,295,360,0.8194,65,130,2.166666667,3.8,79
sub-2085_ses-T1,126,360,0.35,234,468,7.8,3.8,80
sub-2086_ses-T1,17,360,0.0472,343,686,11.43333333,3.8,81
sub-2087_ses-T1,312,360,0.8667,48,96,1.6,3.8,82
sub-2088_ses-T1,149,360,0.4139,211,422,7.033333333,3.8,83
sub-2089_ses-T1,129,180,0.7167,51,102,1.7,3.8,84
sub-2091_ses-T1,51,360,0.1417,309,618,10.3,3.8,85
sub-2092_ses-T1,175,360,0.4861,185,370,6.166666667,3.8,86
sub-2093_ses-T1,167,360,0.4639,193,386,6.433333333,3.8,87
sub-2094_ses-T1,162,180,0.9,18,36,0.6,3.8,88
sub-2095_ses-T1,146,360,0.4056,214,428,7.133333333,3.8,89
sub-2096_ses-T1,146,360,0.4056,214,428,7.133333333,3.8,90
sub-2097_ses-T1,293,540,0.5426,247,494,8.233333333,3.8,91
sub-2098_ses-T1,54,360,0.15,306,612,10.2,3.8,92
sub-2099_ses-T1,35,180,0.1944,145,290,4.833333333,3.8,93
sub-2099_ses-T2,69,360,0.1917,291,582,9.7,3.8,94
sub-2100_ses-T1,91,180,0.5056,89,178,2.966666667,3.8,95
sub-2100_ses-T2,75,360,0.2083,285,570,9.5,3.8,96
sub-2101_ses-T1,147,360,0.4083,213,426,7.1,3.8,97
sub-2101_ses-T2,114,360,0.3167,246,492,8.2,3.8,98
sub-2102_ses-T1,158,360,0.4389,202,404,6.733333333,3.8,99
sub-2103_ses-T1,120,360,0.3333,240,480,8,3.8,100
sub-2103_ses-T2,193,360,0.5361,167,334,5.566666667,3.8,101
sub-2104_ses-T1,246,387,0.6357,141,282,4.7,3.8,102
sub-2105_ses-T1,205,360,0.5694,155,310,5.166666667,3.8,103
sub-2105_ses-T2,208,360,0.5778,152,304,5.066666667,3.8,104
sub-2106_ses-T1,239,360,0.6639,121,242,4.033333333,3.8,105
sub-2107_ses-T1,81,360,0.225,279,558,9.3,3.8,106
sub-2107_ses-T2,111,360,0.3083,249,498,8.3,3.8,107
sub-2108_ses-T1,296,360,0.8222,64,128,2.133333333,3.8,108
sub-2108_ses-T3,80,141,0.5674,61,122,2.033333333,3.8,109
sub-2109_ses-T1,48,180,0.2667,132,264,4.4,3.8,110
sub-2110_ses-T1,188,274,0.6861,86,172,2.866666667,3.8,111
sub-2115_ses-T1,194,360,0.5389,166,332,5.533333333,3.8,112
sub-2115_ses-T2,105,360,0.2917,255,510,8.5,3.8,113
sub-2117_ses-T1,141,360,0.3917,219,438,7.3,3.8,114
sub-2117_ses-T2,49,360,0.1361,311,622,10.36666667,3.8,115
sub-2118_ses-T1,104,360,0.2889,256,512,8.533333333,3.8,116
sub-2120_ses-T1,147,360,0.4083,213,426,7.1,3.8,117
sub-2122_ses-T1,168,360,0.4667,192,384,6.4,3.8,118
sub-2123_ses-T1,287,360,0.7972,73,146,2.433333333,3.8,119
sub-2124_ses-T1,328,404,0.8119,76,152,2.533333333,3.8,120
sub-2126_ses-T1,178,360,0.4944,182,364,6.066666667,3.8,121
sub-2128_ses-T1,192,360,0.5333,168,336,5.6,3.8,122
sub-2133_ses-T1,126,360,0.35,234,468,7.8,3.8,123
sub-2135_ses-T1,7,19,0.3684,12,24,0.4,3.8,124
sub-2136_ses-T1,277,720,0.3847,443,886,14.76666667,3.8,125
sub-2137_ses-T1,170,720,0.2361,550,1100,18.33333333,3.8,126
sub-2137_ses-T2,102,360,0.2833,258,516,8.6,3.8,127
sub-2138_ses-T1,233,360,0.6472,127,254,4.233333333,3.8,128
sub-2139_ses-T1,67,360,0.1861,293,586,9.766666667,3.8,129
sub-2140_ses-T1,376,379,0.9921,3,6,0.1,3.8,130
sub-2141_ses-T1,121,360,0.3361,239,478,7.966666667,3.8,131
sub-2142_ses-T2,269,360,0.7472,91,182,3.033333333,3.8,132
sub-2143_ses-T1,159,360,0.4417,201,402,6.7,3.8,133
sub-2144_ses-T1,166,372,0.4462,206,412,6.866666667,3.8,134
sub-2145_ses-T1,164,360,0.4556,196,392,6.533333333,3.8,135
sub-2145_ses-T2,47,360,0.1306,313,626,10.43333333,3.8,136
sub-2146_ses-T1,249,360,0.6917,111,222,3.7,3.8,137
sub-2146_ses-T2,240,720,0.3333,480,960,16,3.8,138
sub-2147_ses-T1,78,360,0.2167,282,564,9.4,3.8,139
sub-2147_ses-T2,95,360,0.2639,265,530,8.833333333,3.8,140
sub-2148_ses-T1,310,399,0.7769,89,178,2.966666667,3.8,141
sub-2149_ses-T1,164,360,0.4556,196,392,6.533333333,3.8,142
sub-2150_ses-T1,271,360,0.7528,89,178,2.966666667,3.8,143
sub-2150_ses-T2,152,360,0.4222,208,416,6.933333333,3.8,144
sub-2151_ses-T1,210,720,0.2917,510,1020,17,3.8,145
sub-2151_ses-T2,374,773,0.4838,399,798,13.3,3.8,146
sub-2152_ses-T1,286,360,0.7944,74,148,2.466666667,3.8,147
sub-2152_ses-T2,120,360,0.3333,240,480,8,3.8,148
sub-2153_ses-T1,263,383,0.6867,120,240,4,3.8,149
sub-2154_ses-T2,238,360,0.6611,122,244,4.066666667,3.8,150
sub-2155_ses-T1,121,360,0.3361,239,478,7.966666667,3.8,151
sub-2156_ses-T1,92,360,0.2556,268,536,8.933333333,3.8,152
sub-2157_ses-T1,202,360,0.5611,158,316,5.266666667,3.8,153
sub-2158_ses-T1,183,360,0.5083,177,354,5.9,3.8,154
sub-2159_ses-T1,102,360,0.2833,258,516,8.6,3.8,155
sub-2160_ses-T1,58,360,0.1611,302,604,10.06666667,3.8,156
sub-2161_ses-T1,180,360,0.5,180,360,6,3.8,157
sub-2162_ses-T1,202,360,0.5611,158,316,5.266666667,3.8,158
sub-2163_ses-T1,270,399,0.6767,129,258,4.3,3.8,159
sub-2164_ses-T1,128,720,0.1778,592,1184,19.73333333,3.8,160
sub-2164_ses-T2,257,720,0.3569,463,926,15.43333333,3.8,161
sub-2165_ses-T1,162,481,0.3368,319,638,10.63333333,3.8,162
sub-2166_ses-T1,193,360,0.5361,167,334,5.566666667,3.8,163
sub-2166_ses-T2,164,360,0.4556,196,392,6.533333333,3.8,164
sub-2167_ses-T1,245,370,0.6622,125,250,4.166666667,3.8,165
sub-2168_ses-T1,231,360,0.6417,129,258,4.3,3.8,166
sub-2168_ses-T2,162,360,0.45,198,396,6.6,3.8,167
sub-2169_ses-T1,193,360,0.5361,167,334,5.566666667,3.8,168
sub-2169_ses-T2,126,360,0.35,234,468,7.8,3.8,169
sub-2170_ses-T1,94,264,0.3561,170,340,5.666666667,3.8,170
sub-2171_ses-T1,259,374,0.6925,115,230,3.833333333,3.8,171
sub-2171_ses-T2,167,483,0.3458,316,632,10.53333333,3.8,172
sub-2171_ses-T3,109,577,0.1889,468,936,15.6,3.8,173
sub-2172_ses-T1,145,513,0.2827,368,736,12.26666667,3.8,174
sub-2172_ses-T2,247,386,0.6399,139,278,4.633333333,3.8,175
sub-2173_ses-T1,83,360,0.2306,277,554,9.233333333,3.8,176
sub-2174_ses-T1,162,416,0.3894,254,508,8.466666667,3.8,177
sub-2175_ses-T1,433,679,0.6377,246,492,8.2,3.8,178
sub-2176_ses-T1,93,360,0.2583,267,534,8.9,3.8,179
sub-2176_ses-T2,0,360,0,360,720,12,3.8,180
sub-2177_ses-T1,597,695,0.859,98,196,3.266666667,3.8,181
sub-2177_ses-T2,226,736,0.3071,510,1020,17,3.8,182
sub-2178_ses-T2,86,360,0.2389,274,548,9.133333333,3.8,183
sub-2179_ses-T2,270,720,0.375,450,900,15,3.8,184
sub-2180_ses-T1,116,360,0.3222,244,488,8.133333333,3.8,185
sub-2180_ses-T2,23,360,0.0639,337,674,11.23333333,3.8,186
sub-2181_ses-T1,239,360,0.6639,121,242,4.033333333,3.8,187
sub-2182_ses-T1,29,51,0.5686,22,44,0.733333333,3.8,188
sub-2184_ses-T1,242,391,0.6189,149,298,4.966666667,3.8,189
sub-2185_ses-T1,148,360,0.4111,212,424,7.066666667,3.8,190
sub-2186_ses-T1,28,371,0.0755,343,686,11.43333333,3.8,191
sub-2187_ses-T1,31,48,0.6458,17,34,0.566666667,3.8,192
sub-2188_ses-T1,303,445,0.6809,142,284,4.733333333,3.8,193
sub-2189_ses-T1,164,204,0.8039,40,80,1.333333333,3.8,194
sub-2190_ses-T1,154,360,0.4278,206,412,6.866666667,3.8,195
sub-2191_ses-T1,198,360,0.55,162,324,5.4,3.8,196
sub-2191_ses-T2,0,360,0,360,720,12,3.8,197
sub-2192_ses-T1,198,360,0.55,162,324,5.4,3.8,198
sub-2193_ses-T2,397,625,0.6352,228,456,7.6,3.8,199
sub-2194_ses-T1,200,415,0.4819,215,430,7.166666667,3.8,200
sub-2195_ses-T1,51,360,0.1417,309,618,10.3,3.8,201
sub-2196_ses-T1,95,416,0.2284,321,642,10.7,3.8,202
sub-2197_ses-T1,273,439,0.6219,166,332,5.533333333,3.8,203
sub-2197_ses-T2,58,384,0.151,326,652,10.86666667,3.8,204
sub-2198_ses-T1,216,407,0.5307,191,382,6.366666667,3.8,205
sub-2199_ses-T1,226,404,0.5594,178,356,5.933333333,3.8,206
sub-2200_ses-T1,104,360,0.2889,256,512,8.533333333,3.8,207
sub-2201_ses-T1,187,360,0.5194,173,346,5.766666667,3.8,208
sub-2202_ses-T1,114,606,0.1881,492,984,16.4,3.8,209
sub-2203_ses-T1,84,360,0.2333,276,552,9.2,3.8,210
sub-2204_ses-T1,188,360,0.5222,172,344,5.733333333,3.8,211
sub-2204_ses-T2,192,360,0.5333,168,336,5.6,3.8,212
sub-2205_ses-T1,124,360,0.3444,236,472,7.866666667,3.8,213
sub-2206_ses-T1,248,360,0.6889,112,224,3.733333333,3.8,214
sub-2206_ses-T2,216,720,0.3,504,1008,16.8,3.8,215
sub-2207_ses-T1,52,360,0.1444,308,616,10.26666667,3.8,216
sub-2207_ses-T2,51,360,0.1417,309,618,10.3,3.8,217
sub-2208_ses-T1,232,360,0.6444,128,256,4.266666667,3.8,218
sub-2208_ses-T2,117,360,0.325,243,486,8.1,3.8,219
sub-2209_ses-T1,179,341,0.5249,162,324,5.4,3.8,220
sub-2210_ses-T1,24,38,0.6316,14,28,0.466666667,3.8,221
sub-2211_ses-T1,152,360,0.4222,208,416,6.933333333,3.8,222
sub-2212_ses-T1,220,360,0.6111,140,280,4.666666667,3.8,223
sub-2213_ses-T1,86,286,0.3007,200,400,6.666666667,3.8,224
sub-2214_ses-T1,298,373,0.7989,75,150,2.5,3.8,225
sub-2215_ses-T1,196,360,0.5444,164,328,5.466666667,3.8,226
sub-2216_ses-T1,16,86,0.186,70,140,2.333333333,3.8,227
sub-2216_ses-T2,56,181,0.3094,125,250,4.166666667,3.8,228
sub-2217_ses-T1,54,360,0.15,306,612,10.2,3.8,229
sub-2217_ses-T2,13,360,0.0361,347,694,11.56666667,3.8,230
sub-2218_ses-T1,121,360,0.3361,239,478,7.966666667,3.8,231
sub-2218_ses-T2,112,720,0.1556,608,1216,20.26666667,3.8,232
sub-2219_ses-T1,287,360,0.7972,73,146,2.433333333,3.8,233
sub-2220_ses-T1,245,360,0.6806,115,230,3.833333333,3.8,234
sub-2220_ses-T2,16,720,0.0222,704,1408,23.46666667,3.8,235
sub-2221_ses-T1,53,360,0.1472,307,614,10.23333333,3.8,236
sub-2221_ses-T2,264,720,0.3667,456,912,15.2,3.8,237
sub-2222_ses-T1,107,360,0.2972,253,506,8.433333333,3.8,238
sub-2223_ses-T1,147,360,0.4083,213,426,7.1,3.8,239
sub-2223_ses-T2,130,720,0.1806,590,1180,19.66666667,3.8,240
sub-2224_ses-T1,127,379,0.3351,252,504,8.4,3.8,241
sub-2225_ses-T1,182,360,0.5056,178,356,5.933333333,3.8,242
sub-2225_ses-T2,160,759,0.2108,599,1198,19.96666667,3.8,243
sub-2226_ses-T1,74,365,0.2027,291,582,9.7,3.8,244
sub-2226_ses-T2,26,360,0.0722,334,668,11.13333333,3.8,245
sub-2227_ses-T1,159,360,0.4417,201,402,6.7,3.8,246
sub-2228_ses-T1,178,360,0.4944,182,364,6.066666667,3.8,247
sub-2228_ses-T2,207,729,0.284,522,1044,17.4,3.8,248
sub-2229_ses-T1,284,360,0.7889,76,152,2.533333333,3.8,249
sub-2229_ses-T2,44,390,0.1128,346,692,11.53333333,3.8,250
sub-2230_ses-T1,250,398,0.6281,148,296,4.933333333,3.8,251
sub-7001_ses-f2,151,720,0.2097,569,1138,18.96666667,3.8,252
sub-7001_ses-f3,34,720,0.0472,686,1372,22.86666667,3.8,253
sub-7002_ses-f1,117,720,0.1625,603,1206,20.1,3.8,254
sub-7002_ses-f2,228,720,0.3167,492,984,16.4,3.8,255
sub-7003_ses-f1,51,360,0.1417,309,618,10.3,3.8,256
sub-7003_ses-f2,3,180,0.0167,177,354,5.9,3.8,257
sub-7004_ses-f3,254,724,0.3508,470,940,15.66666667,3.8,258
sub-7006_ses-f1,26,52,0.5,26,52,0.866666667,3.8,259
sub-7008_ses-f1,302,720,0.4194,418,836,13.93333333,3.8,260
sub-7008_ses-f2,64,720,0.0889,656,1312,21.86666667,3.8,261
sub-7009_ses-f1,266,720,0.3694,454,908,15.13333333,3.8,262
sub-7009_ses-f2,157,720,0.2181,563,1126,18.76666667,3.8,263
sub-7011_ses-f1,812,917,0.8855,105,210,3.5,3.8,264
sub-7011_ses-f2,82,360,0.2278,278,556,9.266666667,3.8,265
sub-7012_ses-f1,581,761,0.7635,180,360,6,3.8,266
sub-7012_ses-f2,265,720,0.3681,455,910,15.16666667,3.8,267
sub-7014_ses-f1,31,360,0.0861,329,658,10.96666667,3.8,268
sub-7014_ses-f2,236,720,0.3278,484,968,16.13333333,3.8,269
sub-7015_ses-f1,548,832,0.6587,284,568,9.466666667,3.8,270
sub-7015_ses-f2,212,729,0.2908,517,1034,17.23333333,3.8,271
sub-7016_ses-f1,303,750,0.404,447,894,14.9,3.8,272
sub-7016_ses-f2,62,720,0.0861,658,1316,21.93333333,3.8,273
sub-7017_ses-f1,592,740,0.8,148,296,4.933333333,3.8,274
sub-7017_ses-f2,372,725,0.5131,353,706,11.76666667,3.8,275
sub-7020_ses-f1,132,740,0.1784,608,1216,20.26666667,3.8,276
sub-7020_ses-f2,142,720,0.1972,578,1156,19.26666667,3.8,277
sub-7021_ses-f1,565,753,0.7503,188,376,6.266666667,3.8,278
sub-7022_ses-f1,509,720,0.7069,211,422,7.033333333,3.8,279
sub-7022_ses-f2,239,727,0.3287,488,976,16.26666667,3.8,280
sub-7023_ses-f1,327,744,0.4395,417,834,13.9,3.8,281
sub-7023_ses-f2,412,829,0.497,417,834,13.9,3.8,282
sub-7024_ses-f1,473,728,0.6497,255,510,8.5,3.8,283
sub-7025_ses-f1,166,729,0.2277,563,1126,18.76666667,3.8,284
sub-7025_ses-f2,128,760,0.1684,632,1264,21.06666667,3.8,285
sub-7026_ses-f1,470,920,0.5109,450,900,15,3.8,286
sub-7026_ses-f2,468,914,0.512,446,892,14.86666667,3.8,287
sub-7026_ses-f3,79,731,0.1081,652,1304,21.73333333,3.8,288
sub-7027_ses-f1,694,885,0.7842,191,382,6.366666667,3.8,289
sub-7027_ses-f2,80,410,0.1951,330,660,11,3.8,290
sub-7027_ses-f3,49,725,0.0676,676,1352,22.53333333,3.8,291
sub-7028_ses-f1,671,752,0.8923,81,162,2.7,3.8,292
sub-7028_ses-f2,422,720,0.5861,298,596,9.933333333,3.8,293
sub-7029_ses-f1,273,731,0.3735,458,916,15.26666667,3.8,294
sub-7029_ses-f2,199,725,0.2745,526,1052,17.53333333,3.8,295
sub-7030_ses-f1,382,720,0.5306,338,676,11.26666667,3.8,296
sub-7030_ses-f2,188,794,0.2368,606,1212,20.2,3.8,297
sub-7031_ses-f1,9,192,0.0469,183,366,6.1,3.8,298
sub-7031_ses-f2,5,374,0.0134,369,738,12.3,3.8,299
sub-7031_ses-f3,213,737,0.289,524,1048,17.46666667,3.8,300
sub-7032_ses-f1,674,720,0.9361,46,92,1.533333333,3.8,301
sub-7032_ses-f2,34,73,0.4658,39,78,1.3,3.8,302
sub-7032_ses-f3,364,740,0.4919,376,752,12.53333333,3.8,303
sub-7033_ses-f2,241,752,0.3205,511,1022,17.03333333,3.8,304
sub-7034_ses-f1,530,760,0.6974,230,460,7.666666667,3.8,305
sub-7034_ses-f2,425,912,0.466,487,974,16.23333333,3.8,306
sub-7034_ses-f3,75,728,0.103,653,1306,21.76666667,3.8,307
sub-7035_ses-f1,10,50,0.2,40,80,1.333333333,3.8,308
sub-7035_ses-f2,85,727,0.1169,642,1284,21.4,3.8,309
sub-7036_ses-f1,188,745,0.2523,557,1114,18.56666667,3.8,310
sub-7037_ses-f1,714,772,0.9249,58,116,1.933333333,3.8,311
sub-7037_ses-f2,557,852,0.6538,295,590,9.833333333,3.8,312
sub-7037_ses-f3,124,720,0.1722,596,1192,19.86666667,3.8,313
sub-7038_ses-f1,394,789,0.4994,395,790,13.16666667,3.8,314
sub-7038_ses-f2,213,785,0.2713,572,1144,19.06666667,3.8,315
sub-7039_ses-f1,340,785,0.4331,445,890,14.83333333,3.8,316
sub-7039_ses-f2,168,727,0.2311,559,1118,18.63333333,3.8,317
sub-7040_ses-f1,285,728,0.3915,443,886,14.76666667,3.8,318
sub-7040_ses-f2,116,720,0.1611,604,1208,20.13333333,3.8,319
sub-7040_ses-f3,142,720,0.1972,578,1156,19.26666667,3.8,320
sub-7041_ses-f1,444,754,0.5889,310,620,10.33333333,3.8,321
sub-7041_ses-f2,166,735,0.2259,569,1138,18.96666667,3.8,322
sub-7042_ses-f3,185,658,0.2812,473,946,15.76666667,3.8,323
sub-7043_ses-f2,297,1080,0.275,783,1566,26.1,3.8,324
sub-7044_ses-f2,298,739,0.4032,441,882,14.7,3.8,325
sub-7045_ses-f1,427,823,0.5188,396,792,13.2,3.8,326
sub-7046_ses-f1,319,812,0.3929,493,986,16.43333333,3.8,327
sub-7046_ses-f2,29,61,0.4754,32,64,1.066666667,3.8,328
sub-7046_ses-f3,71,741,0.0958,670,1340,22.33333333,3.8,329
sub-7047_ses-f1,288,720,0.4,432,864,14.4,3.8,330
sub-7047_ses-f2,30,64,0.4688,34,68,1.133333333,3.8,331
sub-7048_ses-f1,4,6,0.6667,2,4,0.066666667,3.8,332
sub-7048_ses-f2,125,360,0.3472,235,470,7.833333333,3.8,333
sub-7049_ses-f1,60,360,0.1667,300,600,10,3.8,334
sub-7052_ses-f1,78,518,0.1506,440,880,14.66666667,3.8,335
sub-7053_ses-f1,250,720,0.3472,470,940,15.66666667,3.8,336
sub-7054_ses-f1,438,766,0.5718,328,656,10.93333333,3.8,337